krx -- There is no krx, because it's logically NOTHING	{#MSGBOX -head 'krx' not applicable -text There is no 'krx'. There must be at least one character following 'krx'.  //  krxinfo: {#insert zzKrxInfoText}  //  Phrase-creators: Key-press syntax: {#insert zzKrkSynTxt}}	krx
krxa -- Alt modifier with NOTHING MODIFIED: {#ALT ...}	{#insert zvESC_LVL_CNT_st0}{#insert zKrxaRAW_M_elc}{#insert zzKrkSyn}	krxa
krxal -- {#ALT {#LWIN ...}}	{#insert zvESC_LVL_CNT_st0}{#insert zKrxalRAW_M_elc}{#insert zzKrkSyn}	krxal
krxalp -- krxal, escaped	{#insert zvESC_LVL_CNT_st1}{#insert zKrxalRAW_M_elc}{#insert zzKrkSyn}	krxalp
krxalq -- krxal, doubly-escaped (or more)	{#insert zvESC_LVL_CNT_stPrompt}{#insert zKrxalRAW_M_elc}{#insert zzKrkSyn}	krxalq
krxap -- krxa, escaped	{#insert zvESC_LVL_CNT_st1}{#insert zKrxaRAW_M_elc}{#insert zzKrkSyn}	krxap
krxaq -- krxa, doubly-escaped (or more)	{#insert zvESC_LVL_CNT_stPrompt}{#insert zKrxaRAW_M_elc}{#insert zzKrkSyn}	krxaq
krxas -- {#ALT {#SHIFT ...}}	{#insert zvESC_LVL_CNT_st0}{#insert zKrxasRAW_M_elc}{#insert zzKrkSyn}	krxas
krxasl -- {#ALT {#SHIFT {#LWIN ...}}}	{#insert zvESC_LVL_CNT_st0}{#insert zKrxaslRAW_M_elc}{#insert zzKrkSyn}	krxasl
krxaslp -- krxasl, escaped	{#insert zvESC_LVL_CNT_st1}{#insert zKrxaslRAW_M_elc}{#insert zzKrkSyn}	krxaslp
krxaslq -- krxasl, doubly-escaped (or more)	{#insert zvESC_LVL_CNT_stPrompt}{#insert zKrxaslRAW_M_elc}{#insert zzKrkSyn}	krxaslq
krxasp -- krxas, escaped	{#insert zvESC_LVL_CNT_st1}{#insert zKrxasRAW_M_elc}{#insert zzKrkSyn}	krxasp
krxasq -- krxas, doubly-escaped (or more)	{#insert zvESC_LVL_CNT_stPrompt}{#insert zKrxasRAW_M_elc}{#insert zzKrkSyn}	krxasq
krxc -- {#CTRL ...}	{#insert zvESC_LVL_CNT_st0}{#insert zKrxcRAW_M_elc}{#insert zzKrkSyn}	krxc
krxca -- {#CTRL {#ALT ...}}	{#insert zvESC_LVL_CNT_st0}{#insert zKrxcaRAW_M_elc}{#insert zzKrkSyn}	krxca
krxcal -- {#CTRL {#ALT {#LWIN ...}}}	{#insert zvESC_LVL_CNT_st0}{#insert zKrxcalRAW_M_elc}{#insert zzKrkSyn}	krxcal
krxcalp -- krxcal, escaped	{#insert zvESC_LVL_CNT_st1}{#insert zKrxcalRAW_M_elc}{#insert zzKrkSyn}	krxcalp
krxcalq -- krxcal, doubly-escaped (or more)	{#insert zvESC_LVL_CNT_stPrompt}{#insert zKrxcalRAW_M_elc}{#insert zzKrkSyn}	krxcalq
krxcap -- krxca, escaped	{#insert zvESC_LVL_CNT_st1}{#insert zKrxcaRAW_M_elc}{#insert zzKrkSyn}	krxcap
krxcaq -- krxca, doubly-escaped (or more)	{#insert zvESC_LVL_CNT_stPrompt}{#insert zKrxcaRAW_M_elc}{#insert zzKrkSyn}	krxcaq
krxcas -- {#CTRL {#ALT {#SHIFT ...}}}	{#insert zvESC_LVL_CNT_st0}{#insert zKrxcasRAW_M_elc}{#insert zzKrkSyn}	krxcas
krxcasl -- {#CTRL {#ALT {#SHIFT {#LWIN ...}}}}	{#insert zvESC_LVL_CNT_st0}{#insert zKrxcaslRAW_M_elc}{#insert zzKrkSyn}	krxcasl
krxcaslp -- krxcasl, escaped	{#insert zvESC_LVL_CNT_st1}{#insert zKrxcaslRAW_M_elc}{#insert zzKrkSyn}	krxcaslp
krxcaslq -- krxcasl, doubly-escaped (or more)	{#insert zvESC_LVL_CNT_stPrompt}{#insert zKrxcaslRAW_M_elc}{#insert zzKrkSyn}	krxcaslq
krxcasp -- krxcas, escaped	{#insert zvESC_LVL_CNT_st1}{#insert zKrxcasRAW_M_elc}{#insert zzKrkSyn}	krxcasp
krxcasq -- krxcas, doubly-escaped (or more)	{#insert zvESC_LVL_CNT_stPrompt}{#insert zKrxcasRAW_M_elc}{#insert zzKrkSyn}	krxcasq
krxcl -- {#CTRL {#LWIN ...}}	{#insert zvESC_LVL_CNT_st0}{#insert zKrxclRAW_M_elc}{#insert zzKrkSyn}	krxcl
krxclp -- krxcl, escaped	{#insert zvESC_LVL_CNT_st1}{#insert zKrxclRAW_M_elc}{#insert zzKrkSyn}	krxclp
krxclq -- krxcl, doubly-escaped (or more)	{#insert zvESC_LVL_CNT_stPrompt}{#insert zKrxclRAW_M_elc}{#insert zzKrkSyn}	krxclq
krxcp -- krxc, escaped	{#insert zvESC_LVL_CNT_st1}{#insert zKrxcRAW_M_elc}{#insert zzKrkSyn}	krxcp
krxcq -- krxc, doubly-escaped (or more)	{#insert zvESC_LVL_CNT_stPrompt}{#insert zKrxcRAW_M_elc}{#insert zzKrkSyn}	krxcq
krxcs -- {#CTRL {#SHIFT ...}}	{#insert zvESC_LVL_CNT_st0}{#insert zKrxcsRAW_M_elc}{#insert zzKrkSyn}	krxcs
krxcsl -- {#CTRL {#SHIFT {#LWIN ...}}}	{#insert zvESC_LVL_CNT_st0}{#insert zKrxcslRAW_M_elc}{#insert zzKrkSyn}	krxcsl
krxcslp -- krxcsl, escaped	{#insert zvESC_LVL_CNT_st1}{#insert zKrxcslRAW_M_elc}{#insert zzKrkSyn}	krxcslp
krxcslq -- krxcsl, doubly-escaped (or more)	{#insert zvESC_LVL_CNT_stPrompt}{#insert zKrxcslRAW_M_elc}{#insert zzKrkSyn}	krxcslq
krxcsp -- krxcs, escaped	{#insert zvESC_LVL_CNT_st1}{#insert zKrxcsRAW_M_elc}{#insert zzKrkSyn}	krxcsp
krxcsq -- krxcs, doubly-escaped (or more)	{#insert zvESC_LVL_CNT_stPrompt}{#insert zKrxcsRAW_M_elc}{#insert zzKrkSyn}	krxcsq
krxl -- {#LWIN ...}	{#insert zvESC_LVL_CNT_st0}{#insert zKrxlRAW_M_elc}{#insert zzKrkSyn}	krxl
krxlp -- krxl, escaped	{#insert zvESC_LVL_CNT_st1}{#insert zKrxlRAW_M_elc}{#insert zzKrkSyn}	krxlp
krxlq -- krxl, doubly-escaped (or more)	{#insert zvESC_LVL_CNT_stPrompt}{#insert zKrxlRAW_M_elc}{#insert zzKrkSyn}	krxlq
krxs -- {#SHIFT ...}	{#insert zvESC_LVL_CNT_st0}{#insert zKrxsRAW_M_elc}{#insert zzKrkSyn}	krxs
krxsl -- {#SHIFT {#LWIN ...}}	{#insert zvESC_LVL_CNT_st0}{#insert zKrxslRAW_M_elc}{#insert zzKrkSyn}	krxsl
krxslp -- krxsl, escaped	{#insert zvESC_LVL_CNT_st1}{#insert zKrxslRAW_M_elc}{#insert zzKrkSyn}	krxslp
krxslq -- krxsl, doubly-escaped (or more)	{#insert zvESC_LVL_CNT_stPrompt}{#insert zKrxslRAW_M_elc}{#insert zzKrkSyn}	krxslq
krxsp -- krxs, escaped	{#insert zvESC_LVL_CNT_st1}{#insert zKrxsRAW_M_elc}{#insert zzKrkSyn}	krxsp
krxsq -- krxs, doubly-escaped (or more)	{#insert zvESC_LVL_CNT_stPrompt}{#insert zKrxsRAW_M_elc}{#insert zzKrkSyn}	krxsq
zKrxaRAW_M_elc -- Needs zvESC_LVL_CNT (assumed good value!)	{#insert zOY_M_elc}#ALT {#insert zCY_M_elc}{#insert zzLeftPrevEscCrly_M_elc}	zKrxaRAW_M_elc
zKrxalRAW_M_elc	{#insert zOY_M_elc}#ALT {#insert zOY_M_elc}#LWIN {#insert zCYx2_M_elc}{#insert zzLeftPrevEscCrlyX2_M_elc}	zKrxalRAW_M_elc
zKrxasRAW_M_elc	{#insert zOY_M_elc}#ALT {#insert zOY_M_elc}#SHIFT {#insert zCYx2_M_elc}{#insert zzLeftPrevEscCrlyX2_M_elc}	zKrxasRAW_M_elc
zKrxaslRAW_M_elc	{#insert zOY_M_elc}#ALT {#insert zOY_M_elc}#SHIFT {#insert zOY_M_elc}#LWIN {#insert zCYx3_M_elc}{#insert zzLeftPrevEscCrlyX3_M_elc}	zKrxaslRAW_M_elc
zKrxcRAW_M_elc	{#insert zOY_M_elc}#CTRL {#insert zCY_M_elc}{#insert zzLeftPrevEscCrly_M_elc}	zKrxcRAW_M_elc
zKrxcaRAW_M_elc	{#insert zOY_M_elc}#CTRL {#insert zOY_M_elc}#ALT {#insert zCYx2_M_elc}{#insert zzLeftPrevEscCrlyX2_M_elc}	zKrxcaRAW_M_elc
zKrxcalRAW_M_elc	{#insert zOY_M_elc}#CTRL {#insert zOY_M_elc}#ALT {#insert zOY_M_elc}#LWIN {#insert zCYx3_M_elc}{#insert zzLeftPrevEscCrlyX3_M_elc}	zKrxcalRAW_M_elc
zKrxcasRAW_M_elc	{#insert zOY_M_elc}#CTRL {#insert zOY_M_elc}#ALT {#insert zOY_M_elc}#SHIFT {#insert zCYx3_M_elc}{#insert zzLeftPrevEscCrlyX3_M_elc}	zKrxcasRAW_M_elc
zKrxcaslRAW_M_elc	{#insert zOY_M_elc}#CTRL {#insert zOY_M_elc}#ALT {#insert zOY_M_elc}#SHIFT {#insert zOY_M_elc}#LWIN {#insert zCYx4_M_elc}{#insert zzLeftPrevEscCrlyX4_M_elc}	zKrxcaslRAW_M_elc
zKrxclRAW_M_elc	{#insert zOY_M_elc}#CTRL {#insert zOY_M_elc}#LWIN {#insert zCYx2_M_elc}{#insert zzLeftPrevEscCrlyX2_M_elc}	zKrxclRAW_M_elc
zKrxcsRAW_M_elc	{#insert zOY_M_elc}#CTRL {#insert zOY_M_elc}#SHIFT {#insert zCYx2_M_elc}{#insert zzLeftPrevEscCrlyX2_M_elc}	zKrxcsRAW_M_elc
zKrxcslRAW_M_elc	{#insert zOY_M_elc}#CTRL {#insert zOY_M_elc}#SHIFT {#insert zOY_M_elc}#LWIN {#insert zCYx3_M_elc}{#insert zzLeftPrevEscCrlyX3_M_elc}	zKrxcslRAW_M_elc
zKrxlRAW_M_elc	{#insert zOY_M_elc}#LWIN {#insert zCY_M_elc}{#insert zzLeftPrevEscCrly_M_elc}	zKrxlRAW_M_elc
zKrxsRAW_M_elc	{#insert zOY_M_elc}#SHIFT {#insert zCY_M_elc}{#insert zzLeftPrevEscCrly_M_elc}	zKrxsRAW_M_elc
zKrxslRAW_M_elc	{#insert zOY_M_elc}#SHIFT {#insert zOY_M_elc}#LWIN {#insert zCYx2_M_elc}{#insert zzLeftPrevEscCrlyX2_M_elc}	zKrxslRAW_M_elc
zzKrxAllMainAbrvs1CQBL	[Krxa][Krxc][Krxl][Krxs][Krxal][Krxas][Krxca][Krxcl][Krxcs][Krxsl][Krxasl][Krxcal][Krxcas][Krxcsl][Krxcasl]	zzKrxAllMainAbrvs1CQBL
pcckrxtestall	{#SETPHRASE -description zvQB_STR_LIST -content {#insert zzKrxAllMainAbrvs1CQBL} -autotext zvQB_STR_LIST -folder ctvv_folder}{#insert zzTestAllMainPhrsCrtrAbrvs_M_qbl}	pcckrxtestall
krxinfo	{#BALLOON -title Phrase-creators: Key-presses: krx* -text {#insert zzKrxInfoText}}
zzKrxInfoText	There is no 'krx' phrase-creator, as that would logically output *nothing*. Example use: With '\\\{#ENTER\\\}' in the clipboard, execute 'krxca', then paste: \\\{#CTRL \\\{#ALT \\\{#ENTER\\\}\\\}\\\}	zzKrxInfoText
