kfb -- 0-param link from func-name in CB (requires 1 pre-opt-char)	{#insert zzSetFObjNmCBDrnL1c}<CODE>{#insert z0PFuncLinkDispFNm_M_fnmDrn}</CODE>{#insert zzKflsyn_M_yon}	kfb
kfbk -- kfb, w/ pre-link file-link (requires 2 pre-opt-chars)	{#insert zzSetFObjNmCBDrnPrekL1cX2}<CODE>{#insert z0PFuncLinkDispFNmWPrek_M_fnmDrnPrk}</CODE>{#insert zzKflsyn_M_yon}	kfbk
kfbl -- kfb, non-CODE-d	{#insert zzSetFObjNmCBDrnL1c}{#insert z0PFuncLinkDispFNm_M_fnmDrn}{#insert zzKflsyn_M_yon}	kfbl
kfblk -- kfbl w/ pre-link file-link (requires 2 pre-opt-chars)	{#insert zzSetFObjNmCBDrnPrekL1cX2}{#insert z0PFuncLinkDispFNmWPrek_M_fnmDrnPrk}{#insert zzKflsyn_M_yon}	kfblk
kfby -- kfb, no display-text (y-mark, non-CODE-d, requires 1 pre-opt-char)	{#insert zzSetFObjNmCBDrnL1c}{#insert z0PFuncLinkDsplyYmkPapES_M_fnmDrn}{#insert zzKflsyn_M_yon}	kfby
kfbyc -- kfby, CODE-d (requires 1 pre-opt-char)	{#insert zzSetFObjNmCBDrnL1c}<CODE>{#insert z0PFuncLinkDsplyYmkPapES_M_fnmDrn}</CODE>{#insert zzKflsyn_M_yon}	kfbyc
kfl -- 0-param link from func-name in CB (requires 1 pre-opt-char)	{#insert zzSetDrnL1cFObjNmL1w}<CODE>{#insert z0PFuncLinkDispFNm_M_fnmDrn}</CODE>{#insert zzKflsyn_M_yon}	kfl
kflh -- kfl, target THIS class	{#insert zzSetDrnToHFNmToL1w}<CODE>{#insert z0PFuncLinkDispFNm_M_fnmDrn}</CODE>{#insert zzKflsyn_M_yon}	kflh
kflhl -- kfll, target THIS class	{#insert zzSetDrnToHFNmToL1w}{#insert z0PFuncLinkDispFNm_M_fnmDrn}{#insert zzKflsyn_M_yon}	kflhl
kflk -- kfl w/ pre-link file-link (requires 2 pre-opt-chars)	{#insert zzSetDrnPrekL1cFObjNmL1w}<CODE>{#insert z0PFuncLinkDispFNmWPrek_M_fnmDrnPrk}</CODE>{#insert zzKflsyn_M_yon}	kflk
kflksyn	{#BALLOON -title Syntax: Obj/0~param func~link -text {#insert zzKflksyns}=with pre~link class~file link  //  Options: kfloptsyn  //  [h,i,d,r,n]: kfltgtsyn, [i,I,r,R,y,Y]: kflprksyn  //  WARNING: khbadinfo  //  See: kflsyn  //  javasyn}	kflksyn
zzKflksyns	[i,I,r,R,y,Y][h,i,d,r,n]k[f,o][b,l][l]k	zzKflksyns
kfll -- kfl, non-CODE-d	{#insert zzSetDrnL1cFObjNmL1w}{#insert z0PFuncLinkDispFNm_M_fnmDrn}{#insert zzKflsyn_M_yon}	kfll
kfllk -- kfll w/ pre-link file-link (requires 2 pre-opt-chars)	{#insert zzSetDrnPrekL1cFObjNmL1w}{#insert z0PFuncLinkDispFNmWPrek_M_fnmDrnPrk}{#insert zzKflsyn_M_yon}	kfllk
kfloptsyn	{#BALLOON -title Syntax: kf[b,l] OPTIONS -text [f]=0~param func~link, [o]=internal~object link, [b]=func/obj name in clipboard, [l]=name word~left, [k]=pre~link class~file link (see kflprksyn, WARNING: khbadinfo), [y]=disp y~mk, [yb]=disp in CB  //  Post kf[b,l]: [c]=CODE~d, [l]=non~CODE~d  // kflsyn}	kfloptsyn
kflprksyn	{#BALLOON -title Pre~link class~file link PRE~OPT -text [i,I,r,R,y,Y] declares the style of pre~link class~file link. {#insert zzPreOptsMustBeTxtPrk}  //  WARNING: khbadinfo  //  Example: Ytkfll  //  See: kflsyn}	kflprksyn
kflsyn	{#BALLOON -title Syntax: Obj/0~param func~link -text {#insert zzKflsyns1of4}=disp func/obj~nm  //  {#insert zzKflsyns2of4}=disp y~mk  //  {#insert zzKflsyns3of4}=dsply in CB  //  {#insert zzKflsyns4of4}:tgt='h'  //  Options: kfloptsyn  //  [h,i,d,r,n]: kfltgtsyn, [i,I,r,R,y,Y]: kflprksyn  //  k[fl,ol,nh]testall  //  See: kflksyn  //  javasyn}	kflsyn
zzKflsyns1of4	[h,i,d,r,n]k[f,o][b,l][l]	zzKflsyns1of4
zzKflsyns2of4	k[f,o]by[c]	zzKflsyns2of4
zzKflsyns4of4	kflh[l]	zzKflsyns4of4
zzKflsyns3of4	k[f,o]ly[b][c]	zzKflsyns3of4
kfltestall	{#insert zFcsTPFileNew}{#insert zzDlgStartingTestSynOffWrn}{#insert zzzSetTstDrn2ToPromptPrintClassLnIfR}{#insert zzzSetTstPrk2ToPromptIfDrn2NotH_M_drn2}{#insert zvSYNTAX_ON_stES}kflh{#insert zENTER}doSomething{#insert kflh}{#insert zENTER}kflhl{#insert zENTER}doSomething{#insert kflhl}{#insert zENTER}{#insert zzzTstDrn2}kfb{#insert zzzEtrTstDrn2}{#insert zzScbDmoFncNm}{#insert kfb}{#insert zzzEtrTstDrn2}kfbl{#insert zzzEtrTstDrn2}{#insert zzScbDmoFncNm}{#insert kfbl}{#insert zzzEtrTstDrn2}kfby{#insert zzzEtrTstDrn2}{#insert zzScbDmoFncNm}{#insert kfby}{#insert zzzEtrTstDrn2}kfbyc{#insert zzzEtrTstDrn2}{#insert zzScbDmoFncNm}{#insert kfbyc}{#insert zzzEtrTstDrn2}kfl{#insert zENTER}doSomething{#insert zzzTstDrn2}{#insert kfl}{#insert {#COND -if {#insert zvHIDRUN2} = h -then zzzSkippingKTestsBCHTgtPreOptBal -else zzKfltestallWKOpt}}{#insert zzzEtrTstDrn2}kfll{#insert zENTER}doSomething{#insert zzzTstDrn2}{#insert kfll}{#insert zzzEtrTstDrn2}kfly{#insert zENTER}doSomething{#insert zzzTstDrn2}{#insert kfly}{#insert zzzEtrTstDrn2}kflyb{#insert zENTER}doSomething{#insert zzzScbDmoDisp}{#insert zzzTstDrn2}{#insert kflyb}{#insert zzzEtrTstDrn2}kflybc{#insert zENTER}doSomething{#insert zzzScbDmoDisp}{#insert zzzTstDrn2}{#insert kflybc}{#insert zzzEtrTstDrn2}kflyc{#insert zENTER}doSomething{#insert zzzTstDrn2}{#insert kflyc}{#insert zENTER}{#insert zvSYNTAX_ON_stOn}{#insert zzKflsyn_M_yon}	kfltestall
kfltgtsyn	{#BALLOON -title Class~file target PRE~OPT -text [h,i,d,r,n] declares the location of target~class. {#insert zzPreOptsMustBeTxtTgt}  //  Example: tkfll  //  See: kflprksyn  //  WARNINGS: [kh,on]badinfo  //  kflsyn}	kfltgtsyn
kfly -- kfl, no display-text (y-mark, non-CODE-d, requires 1 pre-opt-char)	{#insert zzSetDrnL1cFObjNmL1w}{#insert z0PFuncLinkDsplyYmkPapES_M_fnmDrn}{#insert zzKflsyn_M_yon}	kfly
kflyb -- kfly, display in clipboard	{#insert zzSetDsplyCBDrnL1cFObjNmL1w}{#insert z0PFuncLinkPapES_M_fnmDrnDsp}{#insert zzKflsyn_M_yon}	kflyb
kflybc -- kflyc, display in clipboard	{#insert zzSetDsplyCBDrnL1cFObjNmL1w}<CODE>{#insert z0PFuncLinkPapES_M_fnmDrnDsp}</CODE>{#insert zzKflsyn_M_yon}	kflybc
kflyc -- kfly, CODE-d (requires 1 pre-opt-char)	{#insert zzSetDrnL1cFObjNmL1w}<CODE>{#insert z0PFuncLinkDsplyYmkPapES_M_fnmDrn}</CODE>{#insert zzKflsyn_M_yon}	kflyc
khbadinfo	{#BALLOON -title WARNING: 'h' tgt pre~opt illegal w/ [k] -text Any Java function/object/constructor~link action that contains the [k] option (such as kflk or kgllk) may not have a target~class of THIS (which is the target pre~option~character 'h'~~see k[f,g]ltgtsyn). Attempting so will result in an error.}	khbadinfo
z0PFuncLinkDispFNmWPrek_M_fnmDrnPrk	{#insert z0PFuncLinkDispFNm_M_fnmDrn}{#insert zPostLinkCreatePrekGoBackCIDrnH_M_prk}	z0PFuncLinkDispFNmWPrek_M_fnmDrnPrk
zzKfltestallWKOpt	{#insert zzzEtrTstPrek2Drn2}kfblk{#insert zzzEtrTstPrek2Drn2}{#insert zzScbDmoFncNm}{#insert kfblk}{#insert zzzEtrTstPrek2Drn2}kfbk{#insert zzzEtrTstPrek2Drn2}{#insert zzScbDmoFncNm}{#insert kfbk}{#insert zzzEtrTstPrek2Drn2}kfllk{#insert zENTER}doSomething{#insert zzzTstPrek2Drn2}{#insert kfllk}{#insert zzzEtrTstPrek2Drn2}kflk{#insert zENTER}doSomething{#insert zzzTstPrek2Drn2}{#insert kflk}	zzKfltestallWKOpt
zzScbDmoFncNm	{#SETCLIPBOARD doSomething}	zzScbDmoFncNm
zzSetDrnPrekL1cFObjNmL1w	{#insert zvHIDRUN_stL1c}{#insert zzCutSetPrekL1c}{#insert zvFOBJ_NAME_stL1w}	zzSetDrnPrekL1cFObjNmL1w
zzSetDrnToHFNmToL1w	{#insert zvHIDRUN_stH}{#insert zvFOBJ_NAME_stL1w}	zzSetDrnToHFNmToL1w
