kib	{#insert zzSetClsNmToCBDtdToL1c}<CODE>{#insert zzClassFileLinkDispCNm_M_dtdCnm}</CODE>{#insert zzKibsyn_M_yon}	kib
kibl	{#insert zzSetClsNmToCBDtdToL1c}{#insert zzClassFileLinkDispCNm_M_dtdCnm}{#insert zzKibsyn_M_yon}	kibl
kibsyn	{#BALLOON -title Syntax: Java class~file link -text {#insert zzKibsyns1of2}=class nm in clipboard ([l]=non-CODE-d, [y]=no display <y-mark>, [c]=CODE-d)  //  {#insert zzKibsyns2of2}  ([r]=class~nm=super, [l]=class~nm word~left, [yb]=display in CB)  //  kibtestall  //  javasyn}	kibsyn
zzKibsyns1of2	kib[l,y[c]]	zzKibsyns1of2
zzKibsyns2of2	ki[l,r][l,y[b][c]]	zzKibsyns2of2
kibtestall	{#insert zzJavaTestIntroFileNew}{#insert zvSYNTAX_ON_stES}{#insert zvDIR_TORD2_stPrompt}{#insert zzDemoJavaClassLine}(*{#insert zzzEtrDirTord2}kib{#insert zzzEnterScbDmoClsDtd}{#insert kib}{#insert zzzEtrDirTord2}kibl{#insert zzzEnterScbDmoClsDtd}{#insert kibl}{#insert zzzEtrDirTord2}kiby{#insert zzzEnterScbDmoClsDtd}{#insert kiby}{#insert zzzEtrDirTord2}kibyc{#insert zzzEnterScbDmoClsDtd}{#insert kibyc}{#insert zzzEtrDirTord2}kil{#insert zzzEnterPrntDmoClsDtd}{#insert kil}{#insert zzzEtrDirTord2}kill{#insert zzzEnterPrntDmoClsDtd}{#insert kill}{#insert zzzEtrDirTord2}kily{#insert zzzEnterPrntDmoClsDtd}{#insert kily}*){#insert zzzEtrDirTord2}kilyb{#insert zzzEnterScbDmoDisp}MyClass{#insert zzzTstDirTord2}{#insert kilyb}{#insert zzzEtrDirTord2}kilybc{#insert zzzEnterScbDmoDisp}MyClass{#insert zzzTstDirTord2}{#insert kilybc}{#insert zzzEtrDirTord2}kilyc{#insert zzzEnterPrntDmoClsDtd}{#insert kilyc}{#insert zzzEtrDirTord2}kir{#insert zzzEtrDirTord2}{#insert kir}{#insert zzzEtrDirTord2}kirl{#insert zzzEtrDirTord2}{#insert kirl}{#insert zzzEtrDirTord2}kiry{#insert zzzEtrDirTord2}{#insert kiry}{#insert zzzEtrDirTord2}kiryb{#insert zzzEnterScbDmoDispDtd}{#insert kiryb}{#insert zzzEtrDirTord2}kirybc{#insert zzzEnterScbDmoDispDtd}{#insert kirybc}{#insert zzzEtrDirTord2}kiryc{#insert zzzEtrDirTord2}{#insert kiryc}{#insert zvSYNTAX_ON_stOn}{#insert zzKibsyn_M_yon}	kibtestall
kiby	{#insert zzSetClsNmToCBDtdToL1c}{#insert zzClassFileLinkDispYmk_M_dtdCnm}{#insert zzKibsyn_M_yon}	kiby
kibyc	{#insert zzSetClsNmToCBDtdToL1c}<CODE>{#insert zzClassFileLinkDispYmk_M_dtdCnm}</CODE>{#insert zzKibsyn_M_yon}	kibyc
kil	{#insert zzSetDtdToL1cClsNmToL1w}<CODE>{#insert zzClassFileLinkDispCNm_M_dtdCnm}</CODE>{#insert zzKibsyn_M_yon}	kil
kill	{#insert zzSetDtdToL1cClsNmToL1w}{#insert zzClassFileLinkDispCNm_M_dtdCnm}{#insert zzKibsyn_M_yon}	kill
kily	{#insert zzSetDtdToL1cClsNmToL1w}{#insert zzClassFileLinkDispYmk_M_dtdCnm}{#insert zzKibsyn_M_yon}	kily
kilyb	{#insert zvDISPLAY_stCB}{#insert zzSetDtdToL1cClsNmToL1w}{#insert zzClassFileLink_M_dtdCnmDsp}{#insert zzKibsyn_M_yon}	kilyb
kilybc	{#insert zvDISPLAY_stCB}{#insert zzSetDtdToL1cClsNmToL1w}<CODE>{#insert zzClassFileLink_M_dtdCnmDsp}</CODE>{#insert zzKibsyn_M_yon}	kilybc
kilyc	{#insert zzSetDtdToL1cClsNmToL1w}<CODE>{#insert zzClassFileLinkDispYmk_M_dtdCnm}</CODE>{#insert zzKibsyn_M_yon}	kilyc
kir	{#insert zzSetDtdToL1cClsNmToSuper}<CODE>{#insert zzClassFileLinkDispCNm_M_dtdCnm}</CODE>{#insert zzKibsyn_M_yon}	kir
kirl	{#insert zzSetDtdToL1cClsNmToSuper}{#insert zzClassFileLinkDispCNm_M_dtdCnm}{#insert zzKibsyn_M_yon}	kirl
kiry	{#insert zzSetDtdToL1cClsNmToSuper}{#insert zzClassFileLinkDispYmk_M_dtdCnm}{#insert zzKibsyn_M_yon}	kiry
kiryb	{#insert zvDISPLAY_stCB}{#insert zzSetDtdToL1cClsNmToSuper}{#insert zzClassFileLink_M_dtdCnmDsp}{#insert zzKibsyn_M_yon}	kiryb
kirybc	{#insert zvDISPLAY_stCB}{#insert zzSetDtdToL1cClsNmToSuper}<CODE>{#insert zzClassFileLink_M_dtdCnmDsp}</CODE>{#insert zzKibsyn_M_yon}	kirybc
kiryc	{#insert zzSetDtdToL1cClsNmToSuper}<CODE>{#insert zzClassFileLinkDispYmk_M_dtdCnm}</CODE>{#insert zzKibsyn_M_yon}	kiryc
zYmarkSlash	{#insert zYmark}/	zYmarkSlash
zvDIR_TORD2_stPrompt	{#SETPHRASE -description zvDIR_TORD2 -content {#INPUT -head Class file in this ('t') or diff dir ('d')? -single} -autotext zvDIR_TORD2 -folder ctvv_folder}	zvDIR_TORD2_stPrompt
zvDIR_TORD_stL1c -*-	{#insert zCutL1c}{#SETPHRASE -description zvDIR_TORD -content {#INSERTCLIPBOARD} -autotext zvDIR_TORD -folder ctvv_folder}	zvDIR_TORD_stL1c
zzClassFileLinkDispCNm_M_dtdCnm	{#insert zvDISPLAY_stFncObjNm}{#insert zzClassFileLink_M_dtdCnmDsp}	zzClassFileLinkDispCNm_M_dtdCnm
zzClassFileLinkDispYmk_M_dtdCnm	{#insert zvDISPLAY_stYmk}{#insert zzClassFileLink_M_dtdCnmDsp}	zzClassFileLinkDispYmk_M_dtdCnm
zzClassFileLink_M_dtdCnmDsp -- Needs zvDIR_TORD, zvFOBJ_NAME=class-name, zvDISPLAY	<A HREF={#insert zAscQQ}{#insert {#COND -if {#insert zvDIR_TORD} = t -then z1slp -else {#COND -if {#insert zvDIR_TORD} = d -then zYmarkSlash -else zzErrDlgBadDtd_M_dtd}}}{#insert zvFOBJ_NAME}.html{#insert zAscQQ}>{#insert zvDISPLAY}</A>	zzClassFileLink_M_dtdCnmDsp
zzErrDlgBadDtd_M_dtd	{#MSGBOX -head ERROR -text ERROR ~~ zvDIR_TORD (currently '{#insert zvDIR_TORD}') must be 't' (target class is THIS one) or 'd' (target class is a different one).{#insert zCancelProcNowPostTxt}}	zzErrDlgBadDtd_M_dtd
zzKibsyn_M_yon -- Needs zvSYNTAX_ON	{#insert {#COND -if {#insert zvSYNTAX_ON} = on -then kibsyn -else z1slp}}	zzKibsyn_M_yon
zzSetClsNmToCBDtdToL1c	{#insert zvFOBJ_NAME_stCB}{#insert zvDIR_TORD_stL1c}	zzSetClsNmToCBDtdToL1c
zzSetDtdToL1cClsNmToL1w	{#insert zvDIR_TORD_stL1c}{#insert zvFOBJ_NAME_stL1w}	zzSetDtdToL1cClsNmToL1w
zzSetDtdToL1cClsNmToSuper	{#insert zvDIR_TORD_stL1c}{#insert zXSetFObjNmToSuperClassXDown}	zzSetDtdToL1cClsNmToSuper
zzzEnterPrntDmoClsDtd	{#insert zENTER}MyClass{#insert zzzTstDirTord2}	zzzEnterPrntDmoClsDtd
zzzEnterScbDmoClsDtd	{#insert zENTER}{#SETCLIPBOARD MyClass}{#insert zzzTstDirTord2}	zzzEnterScbDmoClsDtd
zzzEnterScbDmoDisp	{#insert zENTER}{#insert zzzScbDmoDisp}	zzzEnterScbDmoDisp
zzzEnterScbDmoDispDtd	{#insert zENTER}{#insert zzzScbDmoDisp}{#insert zzzTstDirTord2}	zzzEnterScbDmoDispDtd
zzzEtrDirTord2	{#insert zENTER}{#insert zzzTstDirTord2}	zzzEtrDirTord2
zzzTstDirTord2	{#insert zvDIR_TORD2}{#insert zTSlp}	zzzTstDirTord2
