kob -- Internal object link from obj-name in CB (requires 1 pre-opt-char)	{#insert zzSetFObjNmCBDrnL1c}<CODE>{#insert zzObjLinkDsplyONm_M_onmDrn}</CODE>{#insert zzKflsyn_M_yon}	kob
kobk -- kob w/ pre-link file-link (requires 2 pre-opt-chars)	{#insert zzSetFObjNmCBDrnPrekL1cX2}{#insert zzObjLinkDsplyONmWPrek_M_onmDrnPrk}{#insert zzKflsyn_M_yon}	kobk
kobl -- kob, non-CODE-d	{#insert zzSetFObjNmCBDrnL1c}{#insert zzObjLinkDsplyONm_M_onmDrn}{#insert zzKflsyn_M_yon}	kobl
koblk -- kobl w/ pre-link file-link (requires 2 pre-opt-chars)	{#insert zzSetFObjNmCBDrnPrekL1cX2}{#insert zzObjLinkDsplyONmWPrek_M_onmDrnPrk}{#insert zzKflsyn_M_yon}	koblk
koby -- kob, no display-text (y-mark) (requires 1 pre-opt-char)	{#insert zzSetFObjNmCBDrnL1c}{#insert zzObjLinkDsplyYmk_M_onmDrn}{#insert zzKflsyn_M_yon}	koby
kobyc -- koby, CODE-d (requires 1 pre-opt-char)	{#insert zzSetFObjNmCBDrnL1c}<CODE>{#insert zzObjLinkDsplyYmk_M_onmDrn}</CODE>{#insert zzKflsyn_M_yon}	kobyc
kol -- Internal object link from obj-name in CB (requires 1 pre-opt-char)	{#insert zzSetDrnL1cFObjNmL1w}<CODE>{#insert zzObjLinkDsplyONm_M_onmDrn}</CODE>{#insert zzKflsyn_M_yon}	kol
kolk -- kol w/ pre-link file-link (requires 2 pre-opt-chars)	{#insert zzSetDrnPrekL1cHFObjNmL1w}<CODE>{#insert zzObjLinkDsplyONmWPrek_M_onmDrnPrk}</CODE>{#insert zzKflsyn_M_yon}	kolk
koll -- kol, non-CODE-d	{#insert zzSetDrnL1cFObjNmL1w}{#insert zzObjLinkDsplyONm_M_onmDrn}{#insert zzKflsyn_M_yon}	koll
kollk -- koll w/ pre-link file-link (requires 2 pre-opt-chars)	{#insert zzSetDrnPrekL1cHFObjNmL1w}{#insert zzObjLinkDsplyONmWPrek_M_onmDrnPrk}{#insert zzKflsyn_M_yon}	kollk
koltestall	{#insert zFcsTPFileNew}{#insert zzDlgStartingTestSynOffWrn}{#insert zzzSetTstDrn2ToPromptPrintClassLnIfR}{#insert zzzSetTstPrk2ToPromptIfDrn2NotH_M_drn2}{#insert zvSYNTAX_ON_stES}{#insert zzzTstDrn2}kob{#insert zzScbDmoObjNm}{#insert zzzEtrTstDrn2}{#insert kob}{#insert zzzEtrTstDrn2}kobl{#insert zzScbDmoObjNm}{#insert zzzEtrTstDrn2}{#insert kobl}{#insert {#COND -if {#insert zvHIDRUN2} = h -then zzzSkippingKTestsBCHTgtPreOptBal -else zzKoltestallWKOpt}}{#insert zzzEtrTstDrn2}koby{#insert zzScbDmoObjNm}{#insert zzzEtrTstDrn2}{#insert koby}{#insert zzzEtrTstDrn2}kobyc{#insert zzScbDmoObjNm}{#insert zzzEtrTstDrn2}{#insert kobyc}{#insert zzzEtrTstDrn2}kol{#insert zzzEnterDmoObjNmTstDrn2}{#insert kol}{#insert zzzEtrTstDrn2}koll{#insert zzzEnterDmoObjNmTstDrn2}{#insert koll}{#insert zzzEtrTstDrn2}koly{#insert zzzEnterDmoObjNmTstDrn2}{#insert koly}{#insert zzzEtrTstDrn2}kolyb{#insert zzzEnterDmoObjNmTstDrn2}{#insert zzzScbDmoDisp}{#insert kolyb}{#insert zzzEtrTstDrn2}kolybc{#insert zzzEnterDmoObjNmTstDrn2}{#insert zzzScbDmoDisp}{#insert kolybc}{#insert zzzEtrTstDrn2}kolyc{#insert zzzEnterDmoObjNmTstDrn2}{#insert kolyc}{#insert zENTER}{#insert zvSYNTAX_ON_stOn}{#insert zzKflsyn_M_yon}	koltestall
koly -- kol, no display-text (y-mark) (requires 1 pre-opt-char)	{#insert zzSetDrnL1cFObjNmL1w}{#insert zzObjLinkDsplyYmk_M_onmDrn}{#insert zzKflsyn_M_yon}	koly
kolyb -- koly, display in clipboard	{#insert zzSetDsplyCBDrnL1cFObjNmL1w}{#insert zzObjLink_M_onmDrnDsp}{#insert zzKflsyn_M_yon}	kolyb
kolybc -- kolyc, display in clipboard	{#insert zzSetDsplyCBDrnL1cFObjNmL1w}<CODE>{#insert zzObjLink_M_onmDrnDsp}</CODE>{#insert zzKflsyn_M_yon}	kolybc
kolyc -- koly, CODE-d (requires 1 pre-opt-char)	{#insert zzSetDrnL1cFObjNmL1w}<CODE>{#insert zzObjLinkDsplyYmk_M_onmDrn}</CODE>{#insert zzKflsyn_M_yon}	kolyc
nobadinfo	{#BALLOON -title ko[b,l]* and 'n' tgt incompatible -text ko[b,l]* internal~object links are incompatible with the constructor target (the pre~option~character 'n'~~see kfltgtsyn). Attempting this combination will result in an error.  //  kflsyn  //  Also see: khbadinfo}	nobadinfo
zzErrDlgNOBad	{#MSGBOX -head ERROR -text ERROR ~~ Cannot use the 'n' target pre-option-character (zvHIDRUN='{#insert zvHIDRUN}') with internal-object links (see nobadinfo).{#insert zCancelProcNowPostTxt}}	zzErrDlgNOBad
zzKoltestallWKOpt	{#insert zzzEtrTstPrek2Drn2}kobk{#insert zzScbDmoObjNm}{#insert zzzEtrTstPrek2Drn2}{#insert kobk}{#insert zzzEtrTstPrek2Drn2}koblk{#insert zzScbDmoObjNm}{#insert zzzEtrTstPrek2Drn2}{#insert koblk}{#insert zzzEtrTstPrek2Drn2}kolk{#insert zzzEnterDmoObjNmTstPrek2Drn2}{#insert kolk}{#insert zzzEtrTstPrek2Drn2}kollk{#insert zzzEnterDmoObjNmTstPrek2Drn2}{#insert kollk}	zzKoltestallWKOpt
zzObjLinkDsplyONmWPrek_M_onmDrnPrk	{#insert zzObjLinkDsplyONm_M_onmDrn}{#insert zPostLinkCreatePrekGoBackCIDrnH_M_prk}	zzObjLinkDsplyONmWPrek_M_onmDrnPrk
zzObjLinkDsplyONm_M_onmDrn	{#insert zvDISPLAY_stFncObjNm}{#insert zzObjLink_M_onmDrnDsp}	zzObjLinkDsplyONm_M_onmDrn
zzObjLinkDsplyYmk_M_onmDrn	{#insert zvDISPLAY_stYmk}{#insert zzObjLink_M_onmDrnDsp}	zzObjLinkDsplyYmk_M_onmDrn
zzObjLink_M_onmDrnDsp -- Needs zvHIDRUN (not 'n'!), zvFOBJ_NAME, zvDISPLAY	{#insert {#COND -if {#insert zvHIDRUN} != n -then z1slu -else zzErrDlgNOBad}}{#insert zzObj0PFuncLinkThrFObjNm_M_drnOfm}{#insert zzzObj0PFuncLinkPostUrlPP}	zzObjLink_M_onmDrnDsp
zzScbDmoObjNm	{#SETCLIPBOARD oTheObj}	zzScbDmoObjNm
zzSetDrnPrekL1cHFObjNmL1w	{#insert zvHIDRUN_stL1c}{#insert zzCutSetPrekL1c}{#insert zvFOBJ_NAME_stL1w}	zzSetDrnPrekL1cHFObjNmL1w
zzzEnterDmoObjNmTstDrn2	{#insert zENTER}oTheObj{#insert zzzTstDrn2}	zzzEnterDmoObjNmTstDrn2
zzzEnterDmoObjNmTstPrek2Drn2	{#insert zENTER}oTheObj{#insert zzzTstPrek2Drn2}	zzzEnterDmoObjNmTstPrek2Drn2
