__XBN-PhraseExpress is released under the LGPL 2.1	(*XBN-PhraseExpress is a large set of generically-useful Microsoft Windows scripting tools, written in PhraseExpress, using the plain-text editor TextPad as its foundation.  //  Copyright (C) 2013 Jeff Epstein  //  This library is free software; you can redistribute it and/or modify it under the terms of the GNU Lesser General Public License as published by the Free Software Foundation; either version 2.1 of the License, or (at your option) any later version.  //  This library is distributed in the hope that it will be useful, but WITHOUT ANY WARRANTY; without even the implied warranty of MERCHANTABILITY or FITNESS FOR A PARTICULAR PURPOSE. See the GNU Lesser General Public License for more details.  //  You should have received a copy of the GNU Lesser General Public License along with this library; if not, write to the Free Software Foundation, Inc., 51 Franklin Street, Fifth Floor, Boston, MA 02110-1301 USA*)		(*Two tabs plus this comment, to force this phrase to be (a) imported, and (b) with NO autotext*)
kgb -- 1-plus paramater func link from sig before cursor: See kgbsyn	{#insert zSigInCBSetFuncNmSetCIBParams}{#insert zzSetDrnPapToL1cX2}<CODE>{#insert z1PPFuncLinkDispFNm_M_drnFnmPrmsPap}</CODE>{#insert zzKglsyn_M_yon}	kgb
kgbk -- kgb, w/ pre-link file-link	{#insert zSigInCBSetFuncNmSetCIBParams}{#insert zzSetDrnPapToL1cX2}{#insert zvPREK_stL1c}<CODE>{#insert z1PPFuncLinkDispFNmWPrek_M_drnFnmPrmsPapPrk}</CODE>{#insert zzKglsyn_M_yon}	kgbk
kgbt -- kgb, non-CODE-d	{#insert zSigInCBSetFuncNmSetCIBParams}{#insert zzSetDelDrnPapCIY4NonCddToL1cX2}{#insert z1PPFuncLinkDispFNm_M_drnFnmPrmsPap}{#insert zzKglsyn_M_yon}	kgbt
kgbtk -- kgbk, non-CODE-d	{#insert zSigInCBSetFuncNmSetCIBParams}{#insert zzSetDelDrnPapCIY4NonCddPrekToL1cX3}{#insert z1PPFuncLinkDispFNmWPrek_M_drnFnmPrmsPapPrk}{#insert zzKglsyn_M_yon}	kgbtk
kgby -- kgb, display y-mark, no post-</A> params, non-CODE-d	{#insert zSigInCBSetFuncNmSetCIBParams}{#insert zvDRN_stL1c}{#insert z1PPFuncLinkDispYmkPapES_M_drnFnmPrms}{#insert zzKglsyn_M_yon}	kgby
kgbyc -- kgby, CODE-d	{#insert zSigInCBSetFuncNmSetCIBParams}{#insert zvDRN_stL1c}<CODE>{#insert z1PPFuncLinkDispYmkPapES_M_drnFnmPrms}</CODE>{#insert zzKglsyn_M_yon}	kgbyc
kgl -- 1-plus paramater func link from sig before cursor (see kglsyn)	{#insert zzSetDelDrnPapCIY4NonCddToL1cX2}{#insert zPostSigSetDelParamsFuncNm}<CODE>{#insert z1PPFuncLinkDispFNm_M_drnFnmPrmsPap}</CODE>{#insert zzKglsyn_M_yon}	kgl
kglk -- kgl, w/ pre-link file-link	{#insert zzSetDelDrnPapCIY4NonCddPrekToL1cX3}{#insert zPostSigSetDelParamsFuncNm}<CODE>{#insert z1PPFuncLinkDispFNmWPrek_M_drnFnmPrmsPapPrk}</CODE>{#insert zzKglsyn_M_yon}	kglk
kglksyn	{#BALLOON -title Syntax: 1+ param Java func~link -text {#insert zzKglksyns}=with pre~link class~file link // Options: kgltptsyn // [f,r,y]: kglprksyn, [t,m,v,y]: kglpapsyn, [h,i,d,r,n]: kgltgtsyn // WARNING: khbadinfo // Example: mtkglt // kgltestall // See: kglsyn // javasyn}	kglksyn
kglpapsyn	{#BALLOON -title Post~</A> parameter PRE~OPT -text [t,m,v,y] declares what should be displayed after the closing </A>. {#insert zzPreOptsMustBeTxtPap}  //  Example: mtkglt  //  kglsyn}	kglpapsyn
kglprksyn	{#BALLOON -title Pre~link class~file link PRE~OPT -text [t,m,v,y] declares style of pre~link class~file link. {#insert zzPreOptsMustBeTxtPrk}  //  Example: Ymtkglk  //  WARNING: khbadinfo  //  kglsyn}	kglprksyn
kglsyn	{#BALLOON -title Syntax: 1+ param Java func~link -text {#insert zzKglsyns1of3}=display func~nm, CODE-d // {#insert zzKglsyns2of3}=disp y~mk // {#insert zzKglsyns3of3}=disp in CB // [t,m,v,y]: kglpapsyn, [h,i,d,r,n]: kgltgtsyn // Options: kgltptsyn // WARNING: khbadinfo // Example: mtkglt // kgltestall // See: kglksyn // javasyn}	kglsyn
kglt -- kgl, non-CODE-d	{#insert zzSetDelDrnPapCIY4NonCddToL1cX2}{#insert zPostSigSetDelParamsFuncNm}{#insert z1PPFuncLinkDispFNm_M_drnFnmPrmsPap}{#insert zzKglsyn_M_yon}	kglt
kgltestall	{#insert zFcsTPFileNew}{#insert zzDlgStartingTestSynOffWrn}{#insert zzzSetTstDrn2ToPromptPrintClassLnIfR}{#insert zzzSetPapPap2ToPrompt}{#insert zzzSetTstPrk2ToPromptIfDrn2NotH_M_drn2}{#insert zvSYNTAX_ON_stES}Testing function signature:{#insert zENTER}{#insert zzTestFuncSig}{#insert zENTER2}{#insert zzzYLToYTWarningTxt}{#insert zzzEtrPap2Drn2}kgb{#insert zzEtrPap2Drn2SetCBToTestFuncSig}{#insert kgb}{#insert zENTER}{#insert zzzPap2ForNonCddDrn}kgbt{#insert zzzEtrPap2ForNonCdd}{#insert zzzDrn2SetCBToTestFuncSig}{#insert kgbt}{#insert zzzEtrDrn2}kgbyc{#insert zENTER}{#insert zzzDrn2SetCBToTestFuncSig}{#insert kgbyc}{#insert zzzEtrDrn2}kgby{#insert zENTER}{#insert zzzDrn2SetCBToTestFuncSig}{#insert kgby}{#insert zENTER}{#insert zzzPap2ForNonCddDrn}kglt{#insert zzEnterTestFuncSig}{#insert zzzPap2ForNonCddDrn}{#insert kglt}{#insert zzzEtrDrn2}kglybc{#insert zzzEtrFuncSigDrn2}{#SETCLIPBOARD LINK DISPLAY!!!}{#insert kglybc}{#insert zzzEtrDrn2}kglyb{#insert zzzEtrFuncSigDrn2}{#SETCLIPBOARD LINK DISPLAY!!!}{#insert kglyb}{#insert zzzEtrDrn2}kglyc{#insert zzzEtrFuncSigDrn2}{#insert kglyc}{#insert zzzEtrDrn2}kgly{#insert zzzEtrFuncSigDrn2}{#insert kgly}{#insert {#COND -if {#insert zvDRN2} = h -then zzzSkippingKTestsBCHTgtPreOptBal -else zzzKgltestallWKOpt}}{#insert zzzEtrPap2Drn2}kgl{#insert zzEnterTestFuncSig}{#insert zzzPap2Drn2}{#insert kgl}{#insert zvSYNTAX_ON_stOn}{#insert zzKglsyn_M_yon}	kgltestall
kgltgtsyn	{#BALLOON -title Target class PRE~OPT -text [h,i,d,r,n] declares the target class~file. {#insert zzPreOptsMustBeTxtTgt}  //  Example: tkglt  //  WARNING: khbadinfo  //  kglsyn}	kgltgtsyn
kgltk -- kglk, non-CODE-d	{#insert zzSetDelDrnPapCIY4NonCddPrekToL1cX3}{#insert zPostSigSetDelParamsFuncNm}{#insert z1PPFuncLinkDispFNmWPrek_M_drnFnmPrmsPapPrk}{#insert zzKglsyn_M_yon}	kgltk
kgltptsyn	{#BALLOON -title 1+ param Java func~link OPTIONS -text [b]=sig in clipboard, [l]=sig b4 cursor, [c]=CODE-d, [t]=non~CODE~d, [k]=pre~link class~file link (kglprksyn, WARNING: khbadinfo), [y]=no~display (y-mark), [yb]=disp in CB  //  javasyn}	kgltptsyn
kgly -- kgl, display y-mark, no post-</A> params, non-CODE-d	{#insert zvDRN_stL1c}{#insert zPostSigSetDelParamsFuncNm}{#insert z1PPFuncLinkDispYmkPapES_M_drnFnmPrms}{#insert zzKglsyn_M_yon}	kgly
kglyb -- kgly, display-text in clipboard, non-CODE-d	{#insert zvDISPLAY_stCB}{#insert zvDRN_stL1c}{#insert zPostSigSetDelParamsFuncNm}<CODE>{#insert z1PPFuncLinkPapES_M_drnFnmPrmsDsp}</CODE>{#insert zzKglsyn_M_yon}	kglyb
kglybc -- kglyb, CODE-d	{#insert zvDISPLAY_stCB}{#insert zvDRN_stL1c}{#insert zPostSigSetDelParamsFuncNm}{#insert z1PPFuncLink_M_drnFnmPrmsDspPap}{#insert zzKglsyn_M_yon}	kglybc
kglyc -- kgly, CODE-d	{#insert zvDRN_stL1c}{#insert zPostSigSetDelParamsFuncNm}{#insert zvDISPLAY_stYmk}<CODE>{#insert z1PPFuncLink_M_drnFnmPrmsDspPap}</CODE>{#insert zzKglsyn_M_yon}	kglyc
z1PPFuncLinkDispFNmWPrek_M_drnFnmPrmsPapPrk	{#insert zvDISPLAY_stFncObjNm}{#insert z1PPFuncLinkWPrek_M_drnFnmPrmsDspPapPrk}	z1PPFuncLinkDispFNmWPrek_M_drnFnmPrmsPapPrk
z1PPFuncLinkDispYmkPapES_M_drnFnmPrms	{#insert zvDISPLAY_stYmk}{#insert z1PPFuncLinkPapES_M_drnFnmPrmsDsp}	z1PPFuncLinkDispYmkPapES_M_drnFnmPrms
z1PPFuncLinkPapES_M_drnFnmPrmsDsp	{#insert zvPAP_stT}{#insert z1PPFuncLink_M_drnFnmPrmsDspPap}	z1PPFuncLinkPapES_M_drnFnmPrmsDsp
zPostSigSetDelParamsFuncNm -- Sets zvFOBJ_NAME, zvALL_PARAMS	{#insert zPostParamsSetDel}{#insert zCutL1w}{#insert zvFOBJ_NAME_stCB}	zPostSigSetDelParamsFuncNm
zzEnterTestFuncSig	{#insert zENTER}{#insert zzTestFuncSig}	zzEnterTestFuncSig
zzEtrPap2Drn2SetCBToTestFuncSig	{#insert zzzEtrPap2}{#insert zzzDrn2SetCBToTestFuncSig}	zzEtrPap2Drn2SetCBToTestFuncSig
zzKglksyns	[f,r,y][t,m,v,y][h,i,d,r,n]kg[b,l][t]k	zzKglksyns
zzKglsyn_M_yon -- Needs zvSYNTAX_ON	{#insert {#COND -if {#insert zvSYNTAX_ON} = on -then kglsyn -else z1slp}}	zzKglsyn_M_yon
zzKglsyns1of3	[t,m,v,y][h,i,d,r,n]kg[b,l][t]	zzKglsyns1of3
zzKglsyns2of3	kg[b,l]y[c]	zzKglsyns2of3
zzKglsyns3of3	kglyb[c]	zzKglsyns3of3
zzSetCBToTestFuncSig	{#SETCLIPBOARD {#insert zzTestFuncSig}}	zzSetCBToTestFuncSig
zzSetDelDrnPapCIY4NonCddPrekToL1cX3	{#insert zzSetDelDrnPapCIY4NonCddToL1cX2}{#insert zvPREK_stL1c}	zzSetDelDrnPapCIY4NonCddPrekToL1cX3
zzSetDelDrnPapCIY4NonCddToL1cX2	{#insert zvDRN_stL1c}{#insert zzSetPapToL1cCIY4NonCdd}	zzSetDelDrnPapCIY4NonCddToL1cX2
zzSetDrnPapToL1cX2	{#insert zvDRN_stL1c}{#insert zvPAP_stL1c}	zzSetDrnPapToL1cX2
zzTestFuncSig	doSomething{#insert zzTestFuncParams}	zzTestFuncSig
zzzEtrFuncSigDrn2	{#insert zzEnterTestFuncSig}{#insert zzzDrn2}	zzzEtrFuncSigDrn2
zzzEtrPrekPapDrn	{#insert zENTER}{#insert zzzPrek2Pap2Drn2}	zzzEtrPrekPapDrn
zzzKgltestallWKOpt	{#insert zzzEtrPrekPapDrn}kgbk{#insert zzzEtrPrekPapDrn}{#insert zzSetCBToTestFuncSig}{#insert kgbk}{#insert zENTER}{#insert zzzPrek2Pap2ForNonCddDrn}kgbtk{#insert zENTER}{#insert zzzPrek2Pap2ForNonCddDrn}{#insert zzSetCBToTestFuncSig}{#insert kgbtk}{#insert zzzEtrPrekPapDrn}kglk{#insert zzEnterTestFuncSig}{#insert zzzPrek2Pap2Drn2}{#insert kglk}{#insert zENTER}{#insert zzzPrek2Pap2ForNonCddDrn}kgltk{#insert zzEnterTestFuncSig}{#insert zzzPrek2Pap2ForNonCddDrn}{#insert kgltk}	zzzKgltestallWKOpt
zzzDrn2SetCBToTestFuncSig	{#insert zzzDrn2}{#insert zzSetCBToTestFuncSig}	zzzDrn2SetCBToTestFuncSig
zzzPap2ForNonCddDrn	{#insert zzzPap2ForNonCdd}{#insert zzzDrn2}	zzzPap2ForNonCddDrn
zzzPrek2Pap2Drn2	{#insert zzzPrek2}{#insert zzzPap2Drn2}	zzzPrek2Pap2Drn2
zzzPrek2Pap2ForNonCddDrn	{#insert zzzPrek2}{#insert zzzPap2ForNonCddDrn}	zzzPrek2Pap2ForNonCddDrn
