zTpkcActivateClipLibNbsKcCount	1	zTpkcActivateClipLibNbsKcCount
zTpkcActivateClipLibNbsKcEsc1	\\\{#insert zApTWO\\\}\\\{#sleep 10\\\}	zTpkcActivateClipLibNbsKcEsc1
zTpkcActivateDocumentNbsKcCount	0	zTpkcActivateDocumentNbsKcCount
zTpkcActivateExplorerNbsKcCount	1	zTpkcActivateExplorerNbsKcCount
zTpkcActivateExplorerNbsKcEsc1	\\\{#insert zApTHREE\\\}\\\{#sleep 10\\\}	zTpkcActivateExplorerNbsKcEsc1
zTpkcActivateSearchResultsNbsKcCount	1	zTpkcActivateSearchResultsNbsKcCount
zTpkcActivateSearchResultsNbsKcEsc1	\\\{#insert zApFOUR\\\}\\\{#sleep 10\\\}	zTpkcActivateSearchResultsNbsKcEsc1
zTpkcActivateSelectorNbsKcCount	1	zTpkcActivateSelectorNbsKcCount
zTpkcActivateSelectorNbsKcEsc1	\\\{#insert zApONE\\\}\\\{#sleep 10\\\}	zTpkcActivateSelectorNbsKcEsc1
zTpkcActivateToolOutputNbsKcCount	1	zTpkcActivateToolOutputNbsKcCount
zTpkcActivateToolOutputNbsKcEsc1	\\\{#insert zApFIVE\\\}\\\{#sleep 10\\\}	zTpkcActivateToolOutputNbsKcEsc1
zTpkcStayOnTopNbsKcCount	0	zTpkcStayOnTopNbsKcCount
zTpkcViewClipLibNbsKcCount	1	zTpkcViewClipLibNbsKcCount
zTpkcViewClipLibNbsKcEsc1	\\\{#insert zCpF3\\\}\\\{#sleep 10\\\}	zTpkcViewClipLibNbsKcEsc1
zTpkcViewDocSelectorNbsKcCount	1	zTpkcViewDocSelectorNbsKcCount
zTpkcViewDocSelectorNbsKcEsc1	\\\{#insert zF11\\\}\\\{#sleep 10\\\}	zTpkcViewDocSelectorNbsKcEsc1
zTpkcViewExplorerNbsKcCount	0	zTpkcViewExplorerNbsKcCount
zTpkcViewFindDialogBoxNbsKcCount	0	zTpkcViewFindDialogBoxNbsKcCount
zTpkcViewFullPathsNbsKcCount	0	zTpkcViewFullPathsNbsKcCount
zTpkcViewFullScreenNbsKcCount	0	zTpkcViewFullScreenNbsKcCount
zTpkcViewHScrollbarNbsKcCount	1	zTpkcViewHScrollbarNbsKcCount
zTpkcViewHScrollbarNbsKcEsc1	\\\{#insert zCpQQ\\\}\\\{#sleep 25\\\}\\\{#insert zHH\\\}\\\{#sleep 10\\\}	zTpkcViewHScrollbarNbsKcEsc1
zTpkcViewInBrowserNbsKcCount	0	zTpkcViewInBrowserNbsKcCount
zTpkcViewLineNumbersNbsKcCount	1	zTpkcViewLineNumbersNbsKcCount
zTpkcViewLineNumbersNbsKcEsc1	\\\{#insert zCpQQ\\\}\\\{#sleep 25\\\}\\\{#insert zLL\\\}\\\{#sleep 10\\\}	zTpkcViewLineNumbersNbsKcEsc1
zTpkcViewPropertiesNbsKcCount	0	zTpkcViewPropertiesNbsKcCount
zTpkcViewReplaceDialogBoxNbsKcCount	0	zTpkcViewReplaceDialogBoxNbsKcCount
zTpkcViewSearchResultsNbsKcCount	1	zTpkcViewSearchResultsNbsKcCount
zTpkcViewSearchResultsNbsKcEsc1	\\\{#insert zSpF11\\\}\\\{#sleep 10\\\}	zTpkcViewSearchResultsNbsKcEsc1
zTpkcViewStatusBarNbsKcCount	0	zTpkcViewStatusBarNbsKcCount
zTpkcViewTabSelectorNbsKcCount	0	zTpkcViewTabSelectorNbsKcCount
zTpkcViewToolOutputNbsKcCount	1	zTpkcViewToolOutputNbsKcCount
zTpkcViewToolOutputNbsKcEsc1	\\\{#insert zCpF11\\\}\\\{#sleep 10\\\}	zTpkcViewToolOutputNbsKcEsc1
zTpkcViewVisibleSpacesNbsKcCount	1	zTpkcViewVisibleSpacesNbsKcCount
zTpkcViewVisibleSpacesNbsKcEsc1	\\\{#insert zCpQQ\\\}\\\{#sleep 25\\\}\\\{#insert zII\\\}\\\{#sleep 10\\\}	zTpkcViewVisibleSpacesNbsKcEsc1
zTpkcViewVScrollbarNbsKcCount	1	zTpkcViewVScrollbarNbsKcCount
zTpkcViewVScrollbarNbsKcEsc1	\\\{#insert zCpQQ\\\}\\\{#sleep 25\\\}\\\{#insert zVV\\\}\\\{#sleep 10\\\}	zTpkcViewVScrollbarNbsKcEsc1
