__XBN-PhraseExpress is released under the LGPL 2.1	(*XBN-PhraseExpress: Large set of generically useful scripting tools for MS Windows, written in PhraseExpress and TextPad.  //  Copyright (C) 2013 Jeff Epstein  //  This library is free software; you can redistribute it and/or modify it under the terms of the GNU Lesser General Public License as published by the Free Software Foundation; either version 2.1 of the License, or (at your option) any later version.  //  This library is distributed in the hope that it will be useful, but WITHOUT ANY WARRANTY; without even the implied warranty of MERCHANTABILITY or FITNESS FOR A PARTICULAR PURPOSE. See the GNU Lesser General Public License for more details.  //  You should have received a copy of the GNU Lesser General Public License along with this library; if not, write to the Free Software Foundation, Inc., 51 Franklin Street, Fifth Floor, Boston, MA 02110-1301 USA*)		(*Two tabs plus this comment, to force this phrase to be (a) imported, and (b) with NO autotext*)
<I>Should</I> be non-<CODE>null</CODE>	<I>Should</I> {#insert zzBnn}	Should b
<I>Should</I> be non-<CODE>null</CODE> and non-empty	<I>Should</I> {#insert zzBnne}	Should b
<I>Should</I> not be <CODE>null</CODE>	<I>Should</I> {#insert zzNbn}	Should n
<I>Should</I> not be <CODE>null</CODE> or empty	<I>Should</I> {#insert zzNbne}	Should n
<I>should</I> be non-<CODE>null</CODE>	<I>should</I> {#insert zzBnn}	should b
<I>should</I> be non-<CODE>null</CODE> and non-empty	<I>should</I> {#insert zzBnne}	should b
<I>should</I> not be <CODE>null</CODE>	<I>should</I> {#insert zzNbn}	should n
<I>should</I> not be <CODE>null</CODE> or empty	<I>should</I> {#insert zzNbne}	should n
May not be <CODE>null</CODE>	May {#insert zzNbn}	May n
May not be <CODE>null</CODE> or empty	May {#insert zzNbne}	May n
Must be non-<CODE>null</CODE>	Must {#insert zzBnn}	Must b
Must be non-<CODE>null</CODE> and non-empty	Must {#insert zzBnne}	Must b
may not be <CODE>null</CODE>	May {#insert zzNbn}	may n
may not be <CODE>null</CODE> or empty	May {#insert zzNbne}	may n
must be non-<CODE>null</CODE>	Must {#insert zzBnn}	must b
must be non-<CODE>null</CODE> and non-empty	Must {#insert zzBnne}	must b
zzBnn -- STARTING W/ A SPACE ADDS AN **EXTRA** SPACE	be non-<CODE>null</CODE>	zzBnn
zzBnne -- BUT NO SPACE RESULTS IN **NO** SPACE.	{#insert zzBnn} and non-empty	zzBnne
zzNbn -- MUST APPEND A SPACE BEFORE CALLING	not be <CODE>null</CODE>	zzNbn
zzNbne -- ANY OF THESE.	{#insert zzNbn} or empty	zzNbne
