pnplv -- Prep No-Param Link z-mark for abbreViations (**)	(*Call this immediately after a *y* link generation (such as fkgy), where the cursor is just after the </A>. This duplicates the JavaDoc parameters to that location, changing all the x-marks to zJDTypeAbrvMarker, for future replacement to the appropriate type-abbreviations. Note that each parameter should have its XXX there. None should be eliminated (such as XXXint to int) or expanded to the fully-qualified package-name (XXXObject to java.lang.Object).*){#insert zzPnplvRAW}	pnplv
pnplv02 --  Actually pnplv2	{#insert zvNUMBER_st2}{#insert zzPnplvn_MSTR}	pnplv2
pnplv03 -- pnplv3	{#insert zvNUMBER_st3}{#insert zzPnplvn_MSTR}	pnplv3
pnplv04 -- pnplv4	{#insert zvNUMBER_st4}{#insert zzPnplvn_MSTR}	pnplv4
pnplv05 -- pnplv5	{#insert zvNUMBER_st5}{#insert zzPnplvn_MSTR}	pnplv5
pnplv06 -- pnplv6	{#insert zvNUMBER_st6}{#insert zzPnplvn_MSTR}	pnplv6
pnplv07 -- pnplv7	{#insert zvNUMBER_st7}{#insert zzPnplvn_MSTR}	pnplv7
pnplv08 -- pnplv8	{#insert zvNUMBER_st8}{#insert zzPnplvn_MSTR}	pnplv8
pnplv09 -- pnplv9	{#insert zvNUMBER_st9}{#insert zzPnplvn_MSTR}	pnplv9
pnplv10	{#insert zvNUMBER_st10}{#insert zzPnplvn_MSTR}	pnplv10
pnplvn	{#insert zvNUMBER_stPrompt}{#insert zzPnplvn_MSTR}	pnplvn
zJDTypeAbrvMarker	_4TABV_	zJDTypeAbrvMarker
zzPnplvRAW	{#insert zzZGTCpPrevParamsZdnPstSel}{#insert zzRplcXmksWithJDTAbrvMkWITHREon}{#insert zzRightREoff}	zzPnplvRAW
zzPnplvSearchTrm	([(]|,)( ){0,1}{#insert zXmark}	zzPnplvSearchTrm
zzPnplvn_MSTR	{#insert zFindDialogFlagPreCheck}{#insert zzPnplvn_MSTRNoPreCheck}	zzPnplvn_MSTR
zzPnplvn_MSTRNoPreCheck	{#insert zzZGTCpPrevParamsZdnPstSel}{#insert zzRplcXmksWithJDTAbrvMkWITHREon}{#loop {#insert zZDown}{#insert zzZGTCpPrevParamsZdnPstSel}{#insert zzREonRplcXmksWithJDTAbrvMkNO_WITHREon} -count {#insert zvNUMBERMinus1}}{#insert zzRightREoff}	zzPnplvn_MSTRNoPreCheck
zzREonRplcXmksWithJDTAbrvMkNO_WITHREon -- The with-field is already populated.	{#insert zRplcDlgSel}{#insert zzPnplvSearchTrm}{#insert zRplcBtnAllSelHnrClose}	zzREonRplcXmksWithJDTAbrvMkNO_WITHREon
zzRightREoff	{#insert zRIGHT}{#insert zFindDlgOpenRETglClose}	zzRightREoff
zzRplcXmksWithJDTAbrvMkWITHREon	{#insert zRplcDlgSelRE}{#insert zzPnplvSearchTrm}{#insert zRplcFieldWith}$1{#insert zJDTypeAbrvMarker}{#insert zRplcBtnAllSelHnrClose}	zzRplcXmksWithJDTAbrvMkWITHREon
zzZGTCpPrevParamsZdnPstSel	{#insert zZmark}{#insert zGTCopyPrevParens}{#insert zZDownPaste}{#insert zLEFT}{#insert zMatchBracketExtend2}	zzZGTCpPrevParamsZdnPstSel
