__XBN-PhraseExpress is released under the LGPL 2.1	(*XBN-PhraseExpress is a large set of generically-useful Microsoft Windows scripting tools, written in PhraseExpress, using the plain-text editor TextPad as its foundation.  //  Copyright (C) 2013 Jeff Epstein  //  This library is free software you can redistribute it and/or modify it under the terms of the GNU Lesser General Public License as published by the Free Software Foundation either version 2.1 of the License, or (at your option) any later version.  //  This library is distributed in the hope that it will be useful, but WITHOUT ANY WARRANTY without even the implied warranty of MERCHANTABILITY or FITNESS FOR A PARTICULAR PURPOSE. See the GNU Lesser General Public License for more details.  //  You should have received a copy of the GNU Lesser General Public License along with this library if not, write to the Free Software Foundation, Inc., 51 Franklin Street, Fifth Floor, Boston, MA 02110-1301 USA*)		(*Two tabs plus this comment, to force this phrase to be (a) imported, and (b) with NO autotext*)
joptsimple. -- p	org.junit.	jo
_ joptsimple.	org.junit.	jop
_ joptsimple. (z-import statement for word-left)	{#SETPHRASE -description zvPKG -content joptsimple. -autotext zvPKG -folder ctvv_folder}{#insert zCopyL1w}{#insert zzXGTLineAftrPkgTabQImprtSpcSpcPkgIcbColonXDownDelSetCbToPkg_M_pkg}	jop
ArgumentAcceptingOptionSpec	org.junit.joptsimple	jop
BuiltinHelpFormatter	org.junit.BuiltinHelpFormatter	jop
HelpFormatter	org.junit.HelpFormatter	jop
NonOptionArgumentSpec	org.junit.NonOptionArgumentSpec	jop
OptionalArgumentOptionSpec	org.junit.OptionalArgumentOptionSpec	jop
OptionDescriptor	org.junit.OptionDescriptor	jop
OptionException	org.junit.OptionException	jop
OptionParser	org.junit.OptionParser	jop
OptionSet	org.junit.OptionSet	jop
OptionSpec	org.junit.OptionSpec	jop
OptionSpecBuilder	org.junit.OptionSpecBuilder	jop
OptionSpecTokenizer	org.junit.OptionSpecTokenizer	jop
ValueConversionException	org.junit.ValueConversionException	jop
ValueConverter	org.junit.ValueConverter	jop
joptsimple.util -- u	joptsimple.util.	jop
_ joptsimple.util.	joptsimple.util.	jopu
_ joptsimple.util. (z-import statement for word-left)	{#SETPHRASE -description zvPKG -content joptsimple.util. -autotext zvPKG -folder ctvv_folder}{#insert zCopyL1w}{#insert zzXGTLineAftrPkgTabQImprtSpcSpcPkgIcbColonXDownDelSetCbToPkg_M_pkg}	jopu
DateConverter	joptsimple.util.DateConverter	jopu
InetAddressConverter	joptsimple.util.InetAddressConverter	jopu
KeyValuePair	joptsimple.util.KeyValuePair	jopu
RegexMatcher	joptsimple.util.RegexMatcher	jopu
