zFindOpenFlgPreChkWW	{#insert zFindDialogFlagPreCheck}{#insert zTPToggleWW}	zFindOpenFlgPreChkWW
zvJDSFGLL_NUM_st01 --  Actually zvJDSFGLL_NUM_st1	{#SETPHRASE -description zvJDSFGLL_NUM -content 1 -autotext zvJDSFGLL_NUM -folder ctvv_folder}	zvJDSFGLL_NUM_st1
zvJDSFGLL_NUM_st02 -- zvJDSFGLL_NUM_st2	{#SETPHRASE -description zvJDSFGLL_NUM -content 2 -autotext zvJDSFGLL_NUM -folder ctvv_folder}	zvJDSFGLL_NUM_st2
zvJDSFGLL_NUM_st03 -- zvJDSFGLL_NUM_st3	{#SETPHRASE -description zvJDSFGLL_NUM -content 3 -autotext zvJDSFGLL_NUM -folder ctvv_folder}	zvJDSFGLL_NUM_st3
zvJDSFGLL_NUM_st04 -- zvJDSFGLL_NUM_st4	{#SETPHRASE -description zvJDSFGLL_NUM -content 4 -autotext zvJDSFGLL_NUM -folder ctvv_folder}	zvJDSFGLL_NUM_st4
zvJDSFGLL_NUM_st05 -- zvJDSFGLL_NUM_st5	{#SETPHRASE -description zvJDSFGLL_NUM -content 5 -autotext zvJDSFGLL_NUM -folder ctvv_folder}	zvJDSFGLL_NUM_st5
zvJDSFGLL_NUM_st06 -- zvJDSFGLL_NUM_st6	{#SETPHRASE -description zvJDSFGLL_NUM -content 6 -autotext zvJDSFGLL_NUM -folder ctvv_folder}	zvJDSFGLL_NUM_st6
zvJDSFGLL_NUM_st07 -- zvJDSFGLL_NUM_st7	{#SETPHRASE -description zvJDSFGLL_NUM -content 7 -autotext zvJDSFGLL_NUM -folder ctvv_folder}	zvJDSFGLL_NUM_st7
zvJDSFGLL_NUM_st08 -- zvJDSFGLL_NUM_st8	{#SETPHRASE -description zvJDSFGLL_NUM -content 8 -autotext zvJDSFGLL_NUM -folder ctvv_folder}	zvJDSFGLL_NUM_st8
zvJDSFGLL_NUM_st09 -- zvJDSFGLL_NUM_st9	{#SETPHRASE -description zvJDSFGLL_NUM -content 9 -autotext zvJDSFGLL_NUM -folder ctvv_folder}	zvJDSFGLL_NUM_st9
zvJDSFGLL_NUM_st10	{#SETPHRASE -description zvJDSFGLL_NUM -content 10 -autotext zvJDSFGLL_NUM -folder ctvv_folder}	zvJDSFGLL_NUM_st10
zvJDSFGLL_NUM_stPrompt	{#SETPHRASE -description zvJDSFGLL_NUM -content {#input -head How many functions/sig-lines to put in the jd-see? -single} -autotext zvJDSFGLL_NUM -folder ctvv_folder}	zvJDSFGLL_NUM_stPrompt
zzCmaSpc	, (*ends with space*)	zzCmaSpc
zzJdsfglLoopVYupDel2bkspVdnDel -- Needs zvJDSFGLL_NUM, zvDIVIDER_CMD	{#loop {#insert zzJdsfgl_1IMSTR} -count {#insert zvJDSFGLL_NUM}}{#insert zVmark}{#insert zYUp}	zzJdsfglLoopVYupDel2bkspVdnDel
zzJdsfgl_1IMSTR -- Needs zvDIVIDER_CMD	{#insert zHOME}{#insert zVmark}{#insert zENTER}(*<--Pad line*){#insert gsscg}{#insert zDeleteLine}{#insert zYUpPaste}{#insert fkgvc}{#insert {#insert zvDIVIDER_CMD}}{#insert zYmark}{#insert zVDownDelete}{#insert zDEL}(*<--Pad line*)	zzJdsfgl_1IMSTR
zzJdsfgl_MSTR	{#insert zFindOpenFlgPreChkWW}{#insert zzJdsfgl_MSTRNoPreChkOrWW}{#insert zTPToggleWW}	zzJdsfgl_MSTR
zzJdsfgl_MSTRNoPreChkOrWW	{#SETPHRASE -description zvDIVIDER_CMD -content zzCmaSpc -autotext zvDIVIDER_CMD -folder ctvv_folder}{#insert zzJdsfglLoopVYupDel2bkspVdnDel}{#insert zDEL}{#insert zBKSP2}{#insert zVDownDelete}	zzJdsfgl_MSTRNoPreChkOrWW
zzJdsfgll_numMSTR -- Needs zvJDSFGLL_NUM	{#insert zFindOpenFlgPreChkWW}{#insert zzJdsfgll_numMSTR_noPreChkOrWW}{#insert zTPToggleWW}	zzJdsfgll_numMSTR
zzJdsfgll_numMSTR_noPreChkOrWW -- Needs zvJDSFGLL_NUM	{#SETPHRASE -description zvDIVIDER_CMD -content zzNewLI -autotext zvDIVIDER_CMD -folder ctvv_folder}{#insert zzJdsfglLoopVYupDel2bkspVdnDel}{#insert zDeleteLine}{#insert zHOME}{#insert zVDownDelete}	zzJdsfgll_numMSTR_noPreChkOrWW
zzNewLI	</LI>{#insert zENTER}<LI>	zzNewLI
zzOpnCrlEntrBksp	{#insert zOY}{#insert zEnterBksp}	zzOpnCrlEntrBksp
