zzNewFlV1Nbs_chars_Char44OUpperULAccent_ifKc	{#insert zvCMD_ABRV_1C_sfChar44OUpperULAccent}{#insert {#COND -if {#insert zzzHasAKCOrFrcTst_yes_M_cmd1} = yes -then zzzNewFlKcVrfy_chars_aSingleChar_M_cmd1this -else z1slp}}	zzNewFlV1Nbs_chars_Char44OUpperULAccent_ifKc
zzNewFlV1Nbs_chars_Char45OLowerULAccent_ifKc	{#insert zvCMD_ABRV_1C_sfChar45OLowerULAccent}{#insert {#COND -if {#insert zzzHasAKCOrFrcTst_yes_M_cmd1} = yes -then zzzNewFlKcVrfy_chars_aSingleChar_M_cmd1this -else z1slp}}	zzNewFlV1Nbs_chars_Char45OLowerULAccent_ifKc
zzNewFlV1Nbs_chars_Char46OUpperCaret_ifKc	{#insert zvCMD_ABRV_1C_sfChar46OUpperCaret}{#insert {#COND -if {#insert zzzHasAKCOrFrcTst_yes_M_cmd1} = yes -then zzzNewFlKcVrfy_chars_aSingleChar_M_cmd1this -else z1slp}}	zzNewFlV1Nbs_chars_Char46OUpperCaret_ifKc
zzNewFlV1Nbs_chars_Char47OLowerCaret_ifKc	{#insert zvCMD_ABRV_1C_sfChar47OLowerCaret}{#insert {#COND -if {#insert zzzHasAKCOrFrcTst_yes_M_cmd1} = yes -then zzzNewFlKcVrfy_chars_aSingleChar_M_cmd1this -else z1slp}}	zzNewFlV1Nbs_chars_Char47OLowerCaret_ifKc
zzNewFlV1Nbs_chars_Char48OUpperUmlaut_ifKc	{#insert zvCMD_ABRV_1C_sfChar48OUpperUmlaut}{#insert {#COND -if {#insert zzzHasAKCOrFrcTst_yes_M_cmd1} = yes -then zzzNewFlKcVrfy_chars_aSingleChar_M_cmd1this -else z1slp}}	zzNewFlV1Nbs_chars_Char48OUpperUmlaut_ifKc
zzNewFlV1Nbs_chars_Char49OLowerUmlaut_ifKc	{#insert zvCMD_ABRV_1C_sfChar49OLowerUmlaut}{#insert {#COND -if {#insert zzzHasAKCOrFrcTst_yes_M_cmd1} = yes -then zzzNewFlKcVrfy_chars_aSingleChar_M_cmd1this -else z1slp}}	zzNewFlV1Nbs_chars_Char49OLowerUmlaut_ifKc
zzNewFlV1Nbs_chars_Char50OUpperTilde_ifKc	{#insert zvCMD_ABRV_1C_sfChar50OUpperTilde}{#insert {#COND -if {#insert zzzHasAKCOrFrcTst_yes_M_cmd1} = yes -then zzzNewFlKcVrfy_chars_aSingleChar_M_cmd1this -else z1slp}}	zzNewFlV1Nbs_chars_Char50OUpperTilde_ifKc
zzNewFlV1Nbs_chars_Char51OLowerTilde_ifKc	{#insert zvCMD_ABRV_1C_sfChar51OLowerTilde}{#insert {#COND -if {#insert zzzHasAKCOrFrcTst_yes_M_cmd1} = yes -then zzzNewFlKcVrfy_chars_aSingleChar_M_cmd1this -else z1slp}}	zzNewFlV1Nbs_chars_Char51OLowerTilde_ifKc
zzNewFlV1Nbs_chars_Char52OUpperURCross_ifKc	{#insert zvCMD_ABRV_1C_sfChar52OUpperURCross}{#insert {#COND -if {#insert zzzHasAKCOrFrcTst_yes_M_cmd1} = yes -then zzzNewFlKcVrfy_chars_aSingleChar_M_cmd1this -else z1slp}}	zzNewFlV1Nbs_chars_Char52OUpperURCross_ifKc
zzNewFlV1Nbs_chars_Char53OLowerURCross_ifKc	{#insert zvCMD_ABRV_1C_sfChar53OLowerURCross}{#insert {#COND -if {#insert zzzHasAKCOrFrcTst_yes_M_cmd1} = yes -then zzzNewFlKcVrfy_chars_aSingleChar_M_cmd1this -else z1slp}}	zzNewFlV1Nbs_chars_Char53OLowerURCross_ifKc
zzNewFlV1Nbs_chars_Char54SLowerUpperB_ifKc	{#insert zvCMD_ABRV_1C_sfChar54SLowerUpperB}{#insert {#COND -if {#insert zzzHasAKCOrFrcTst_yes_M_cmd1} = yes -then zzzNewFlKcVrfy_chars_aSingleChar_M_cmd1this -else z1slp}}	zzNewFlV1Nbs_chars_Char54SLowerUpperB_ifKc
zzNewFlV1Nbs_chars_Char55UUpperURAccent_ifKc	{#insert zvCMD_ABRV_1C_sfChar55UUpperURAccent}{#insert {#COND -if {#insert zzzHasAKCOrFrcTst_yes_M_cmd1} = yes -then zzzNewFlKcVrfy_chars_aSingleChar_M_cmd1this -else z1slp}}	zzNewFlV1Nbs_chars_Char55UUpperURAccent_ifKc
zzNewFlV1Nbs_chars_Char56ULowerURAccent_ifKc	{#insert zvCMD_ABRV_1C_sfChar56ULowerURAccent}{#insert {#COND -if {#insert zzzHasAKCOrFrcTst_yes_M_cmd1} = yes -then zzzNewFlKcVrfy_chars_aSingleChar_M_cmd1this -else z1slp}}	zzNewFlV1Nbs_chars_Char56ULowerURAccent_ifKc
zzNewFlV1Nbs_chars_Char57UUpperULAccent_ifKc	{#insert zvCMD_ABRV_1C_sfChar57UUpperULAccent}{#insert {#COND -if {#insert zzzHasAKCOrFrcTst_yes_M_cmd1} = yes -then zzzNewFlKcVrfy_chars_aSingleChar_M_cmd1this -else z1slp}}	zzNewFlV1Nbs_chars_Char57UUpperULAccent_ifKc
zzNewFlV1Nbs_chars_Char58ULowerULAccent_ifKc	{#insert zvCMD_ABRV_1C_sfChar58ULowerULAccent}{#insert {#COND -if {#insert zzzHasAKCOrFrcTst_yes_M_cmd1} = yes -then zzzNewFlKcVrfy_chars_aSingleChar_M_cmd1this -else z1slp}}	zzNewFlV1Nbs_chars_Char58ULowerULAccent_ifKc
zzNewFlV1Nbs_chars_Char59UUpperCaret_ifKc	{#insert zvCMD_ABRV_1C_sfChar59UUpperCaret}{#insert {#COND -if {#insert zzzHasAKCOrFrcTst_yes_M_cmd1} = yes -then zzzNewFlKcVrfy_chars_aSingleChar_M_cmd1this -else z1slp}}	zzNewFlV1Nbs_chars_Char59UUpperCaret_ifKc
zzNewFlV1Nbs_chars_Char60ULowerCaret_ifKc	{#insert zvCMD_ABRV_1C_sfChar60ULowerCaret}{#insert {#COND -if {#insert zzzHasAKCOrFrcTst_yes_M_cmd1} = yes -then zzzNewFlKcVrfy_chars_aSingleChar_M_cmd1this -else z1slp}}	zzNewFlV1Nbs_chars_Char60ULowerCaret_ifKc
zzNewFlV1Nbs_chars_Char61UUpperUmlaut_ifKc	{#insert zvCMD_ABRV_1C_sfChar61UUpperUmlaut}{#insert {#COND -if {#insert zzzHasAKCOrFrcTst_yes_M_cmd1} = yes -then zzzNewFlKcVrfy_chars_aSingleChar_M_cmd1this -else z1slp}}	zzNewFlV1Nbs_chars_Char61UUpperUmlaut_ifKc
zzNewFlV1Nbs_chars_Char62ULowerUmlaut_ifKc	{#insert zvCMD_ABRV_1C_sfChar62ULowerUmlaut}{#insert {#COND -if {#insert zzzHasAKCOrFrcTst_yes_M_cmd1} = yes -then zzzNewFlKcVrfy_chars_aSingleChar_M_cmd1this -else z1slp}}	zzNewFlV1Nbs_chars_Char62ULowerUmlaut_ifKc
zzNewFlV1Nbs_chars_Char63YUpperURAccent_ifKc	{#insert zvCMD_ABRV_1C_sfChar63YUpperURAccent}{#insert {#COND -if {#insert zzzHasAKCOrFrcTst_yes_M_cmd1} = yes -then zzzNewFlKcVrfy_chars_aSingleChar_M_cmd1this -else z1slp}}	zzNewFlV1Nbs_chars_Char63YUpperURAccent_ifKc
zzNewFlV1Nbs_chars_Char64YLowerURAccent_ifKc	{#insert zvCMD_ABRV_1C_sfChar64YLowerURAccent}{#insert {#COND -if {#insert zzzHasAKCOrFrcTst_yes_M_cmd1} = yes -then zzzNewFlKcVrfy_chars_aSingleChar_M_cmd1this -else z1slp}}	zzNewFlV1Nbs_chars_Char64YLowerURAccent_ifKc
zzNewFlV1Nbs_chars_Char65YLowerUmlaut_ifKc	{#insert zvCMD_ABRV_1C_sfChar65YLowerUmlaut}{#insert {#COND -if {#insert zzzHasAKCOrFrcTst_yes_M_cmd1} = yes -then zzzNewFlKcVrfy_chars_aSingleChar_M_cmd1this -else z1slp}}	zzNewFlV1Nbs_chars_Char65YLowerUmlaut_ifKc

