__XBN-PhraseExpress is released under the LGPL 2.1	(*XBN-PhraseExpress is a large set of generically-useful Microsoft Windows scripting tools, written in PhraseExpress, using the plain-text editor TextPad as its foundation.  //  Copyright (C) 2013 Jeff Epstein  //  This library is free software; you can redistribute it and/or modify it under the terms of the GNU Lesser General Public License as published by the Free Software Foundation; either version 2.1 of the License, or (at your option) any later version.  //  This library is distributed in the hope that it will be useful, but WITHOUT ANY WARRANTY; without even the implied warranty of MERCHANTABILITY or FITNESS FOR A PARTICULAR PURPOSE. See the GNU Lesser General Public License for more details.  //  You should have received a copy of the GNU Lesser General Public License along with this library; if not, write to the Free Software Foundation, Inc., 51 Franklin Street, Fifth Floor, Boston, MA 02110-1301 USA*)		(*Two tabs plus this comment, to force this phrase to be (a) imported, and (b) with NO autotext*)

zzNewFlV1Nbs_edit_EditAlignCenter_ifKc	{#insert zvCMD_ABRV_1C_sfEditAlignCenter}{#insert {#COND -if {#insert zzzHasAKCOrFrcTst_yes_M_cmd1} = yes -then zzzNoTestForCmdWKc_M_cmd1 -else z1slp}}	zzNewFlV1Nbs_edit_EditAlignCenter_ifKc
zzNewFlV1Nbs_edit_EditAlignJustify_ifKc	{#insert zvCMD_ABRV_1C_sfEditAlignJustify}{#insert {#COND -if {#insert zzzHasAKCOrFrcTst_yes_M_cmd1} = yes -then zzzNoTestForCmdWKc_M_cmd1 -else z1slp}}	zzNewFlV1Nbs_edit_EditAlignJustify_ifKc
zzNewFlV1Nbs_edit_EditAlignLeft_ifKc	{#insert zvCMD_ABRV_1C_sfEditAlignLeft}{#insert {#COND -if {#insert zzzHasAKCOrFrcTst_yes_M_cmd1} = yes -then zzzNoTestForCmdWKc_M_cmd1 -else z1slp}}	zzNewFlV1Nbs_edit_EditAlignLeft_ifKc
zzNewFlV1Nbs_edit_EditAlignRight_ifKc	{#insert zvCMD_ABRV_1C_sfEditAlignRight}{#insert {#COND -if {#insert zzzHasAKCOrFrcTst_yes_M_cmd1} = yes -then zzzNoTestForCmdWKc_M_cmd1 -else z1slp}}	zzNewFlV1Nbs_edit_EditAlignRight_ifKc
zzNewFlV1Nbs_edit_EditBackspace_ifKc	{#insert zvCMD_ABRV_1C_sfEditBackspace}{#insert {#COND -if {#insert zzzHasAKCOrFrcTst_yes_M_cmd1} = yes -then zzzNoTestForCmdWKc_M_cmd1 -else z1slp}}	zzNewFlV1Nbs_edit_EditBackspace_ifKc
zzNewFlV1Nbs_edit_EditCapitalize_ifKc	{#insert zvCMD_ABRV_1C_sfEditCapitalize}{#insert {#COND -if {#insert zzzHasAKCOrFrcTst_yes_M_cmd1} = yes -then zzzNoTestForCmdWKc_M_cmd1 -else z1slp}}	zzNewFlV1Nbs_edit_EditCapitalize_ifKc
zzNewFlV1Nbs_edit_EditClearAll_ifKc	{#insert zvCMD_ABRV_1C_sfEditClearAll}{#insert {#COND -if {#insert zzzHasAKCOrFrcTst_yes_M_cmd1} = yes -then zzzNoTestForCmdWKc_M_cmd1 -else z1slp}}	zzNewFlV1Nbs_edit_EditClearAll_ifKc
zzNewFlV1Nbs_edit_EditCopyAllFileNames_ifKc	{#insert zvCMD_ABRV_1C_sfEditCopyAllFileNames}{#insert {#COND -if {#insert zzzHasAKCOrFrcTst_yes_M_cmd1} = yes -then zzzNoTestForCmdWKc_M_cmd1 -else z1slp}}	zzNewFlV1Nbs_edit_EditCopyAllFileNames_ifKc
zzNewFlV1Nbs_edit_EditCopyAppend_ifKc	{#insert zvCMD_ABRV_1C_sfEditCopyAppend}{#insert {#COND -if {#insert zzzHasAKCOrFrcTst_yes_M_cmd1} = yes -then zzzNoTestForCmdWKc_M_cmd1 -else z1slp}}	zzNewFlV1Nbs_edit_EditCopyAppend_ifKc
zzNewFlV1Nbs_edit_EditCopyAsHTML_ifKc	{#insert zvCMD_ABRV_1C_sfEditCopyAsHTML}{#insert {#COND -if {#insert zzzHasAKCOrFrcTst_yes_M_cmd1} = yes -then zzzNoTestForCmdWKc_M_cmd1 -else z1slp}}	zzNewFlV1Nbs_edit_EditCopyAsHTML_ifKc
zzNewFlV1Nbs_edit_EditCopyFileName_ifKc	{#insert zvCMD_ABRV_1C_sfEditCopyFileName}{#insert {#COND -if {#insert zzzHasAKCOrFrcTst_yes_M_cmd1} = yes -then zzzNoTestForCmdWKc_M_cmd1 -else z1slp}}	zzNewFlV1Nbs_edit_EditCopyFileName_ifKc
zzNewFlV1Nbs_edit_EditCopyLineAppend_ifKc	{#insert zvCMD_ABRV_1C_sfEditCopyLineAppend}{#insert {#COND -if {#insert zzzHasAKCOrFrcTst_yes_M_cmd1} = yes -then zzzNoTestForCmdWKc_M_cmd1 -else z1slp}}	zzNewFlV1Nbs_edit_EditCopyLineAppend_ifKc
zzNewFlV1Nbs_edit_EditCopyLine_ifKc	{#insert zvCMD_ABRV_1C_sfEditCopyLine}{#insert {#COND -if {#insert zzzHasAKCOrFrcTst_yes_M_cmd1} = yes -then zzzNoTestForCmdWKc_M_cmd1 -else z1slp}}	zzNewFlV1Nbs_edit_EditCopyLine_ifKc
zzNewFlV1Nbs_edit_EditCopyTaggedLines_ifKc	{#insert zvCMD_ABRV_1C_sfEditCopyTaggedLines}{#insert zzzNoVerificationForBtstrpsDlg_M_cmd1}	zzNewFlV1Nbs_edit_EditCopyTaggedLines_ifKc
zzNewFlV1Nbs_edit_EditCopyWordAppend_ifKc	{#insert zvCMD_ABRV_1C_sfEditCopyWordAppend}{#insert {#COND -if {#insert zzzHasAKCOrFrcTst_yes_M_cmd1} = yes -then zzzNoTestForCmdWKc_M_cmd1 -else z1slp}}	zzNewFlV1Nbs_edit_EditCopyWordAppend_ifKc
zzNewFlV1Nbs_edit_EditCopyWord_ifKc	{#insert zvCMD_ABRV_1C_sfEditCopyWord}{#insert {#COND -if {#insert zzzHasAKCOrFrcTst_yes_M_cmd1} = yes -then zzzNoTestForCmdWKc_M_cmd1 -else z1slp}}	zzNewFlV1Nbs_edit_EditCopyWord_ifKc
zzNewFlV1Nbs_edit_EditCopy_ifKc	{#insert zvCMD_ABRV_1C_sfEditCopy}{#insert zzzNoVerificationForBtstrpsDlg_M_cmd1}	zzNewFlV1Nbs_edit_EditCopy_ifKc
zzNewFlV1Nbs_edit_EditCutAppend_ifKc	{#insert zvCMD_ABRV_1C_sfEditCutAppend}{#insert {#COND -if {#insert zzzHasAKCOrFrcTst_yes_M_cmd1} = yes -then zzzNoTestForCmdWKc_M_cmd1 -else z1slp}}	zzNewFlV1Nbs_edit_EditCutAppend_ifKc
zzNewFlV1Nbs_edit_EditCutLineAppend_ifKc	{#insert zvCMD_ABRV_1C_sfEditCutLineAppend}{#insert {#COND -if {#insert zzzHasAKCOrFrcTst_yes_M_cmd1} = yes -then zzzNoTestForCmdWKc_M_cmd1 -else z1slp}}	zzNewFlV1Nbs_edit_EditCutLineAppend_ifKc
zzNewFlV1Nbs_edit_EditCutLine_ifKc	{#insert zvCMD_ABRV_1C_sfEditCutLine}{#insert {#COND -if {#insert zzzHasAKCOrFrcTst_yes_M_cmd1} = yes -then zzzNoTestForCmdWKc_M_cmd1 -else z1slp}}	zzNewFlV1Nbs_edit_EditCutLine_ifKc
zzNewFlV1Nbs_edit_EditCutTaggedLines_ifKc	{#insert zvCMD_ABRV_1C_sfEditCutTaggedLines}{#insert zzzNoVerificationForBtstrpsDlg_M_cmd1}	zzNewFlV1Nbs_edit_EditCutTaggedLines_ifKc
zzNewFlV1Nbs_edit_EditCutWordAppend_ifKc	{#insert zvCMD_ABRV_1C_sfEditCutWordAppend}{#insert {#COND -if {#insert zzzHasAKCOrFrcTst_yes_M_cmd1} = yes -then zzzNoTestForCmdWKc_M_cmd1 -else z1slp}}	zzNewFlV1Nbs_edit_EditCutWordAppend_ifKc
zzNewFlV1Nbs_edit_EditCutWord_ifKc	{#insert zvCMD_ABRV_1C_sfEditCutWord}{#insert {#COND -if {#insert zzzHasAKCOrFrcTst_yes_M_cmd1} = yes -then zzzNoTestForCmdWKc_M_cmd1 -else z1slp}}	zzNewFlV1Nbs_edit_EditCutWord_ifKc
