__XBN-PhraseExpress is released under the LGPL 2.1	(*XBN-PhraseExpress is a large set of generically-useful Microsoft Windows scripting tools, written in PhraseExpress, using the plain-text editor TextPad as its foundation.  //  Copyright (C) 2013 Jeff Epstein  //  This library is free software; you can redistribute it and/or modify it under the terms of the GNU Lesser General Public License as published by the Free Software Foundation; either version 2.1 of the License, or (at your option) any later version.  //  This library is distributed in the hope that it will be useful, but WITHOUT ANY WARRANTY; without even the implied warranty of MERCHANTABILITY or FITNESS FOR A PARTICULAR PURPOSE. See the GNU Lesser General Public License for more details.  //  You should have received a copy of the GNU Lesser General Public License along with this library; if not, write to the Free Software Foundation, Inc., 51 Franklin Street, Fifth Floor, Boston, MA 02110-1301 USA*)		(*Two tabs plus this comment, to force this phrase to be (a) imported, and (b) with NO autotext*)
zzNewFlV1Nbs_cursor_LineUp_ifKc	{#insert zvCMD_ABRV_1C_sfLineUp}{#insert {#COND -if {#insert zzzHasAKCOrFrcTst_yes_M_cmd1} = yes -then zzzNoTestForCmdWKc_M_cmd1 -else z1slp}}	zzNewFlV1Nbs_cursor_LineUp_ifKc
zzNewFlV1Nbs_cursor_PageDownExtend_ifKc	{#insert zvCMD_ABRV_1C_sfPageDownExtend}{#insert {#COND -if {#insert zzzHasAKCOrFrcTst_yes_M_cmd1} = yes -then zzzNoTestForCmdWKc_M_cmd1 -else z1slp}}	zzNewFlV1Nbs_cursor_PageDownExtend_ifKc
zzNewFlV1Nbs_cursor_PageDown_ifKc	{#insert zvCMD_ABRV_1C_sfPageDown}{#insert {#COND -if {#insert zzzHasAKCOrFrcTst_yes_M_cmd1} = yes -then zzzNoTestForCmdWKc_M_cmd1 -else z1slp}}	zzNewFlV1Nbs_cursor_PageDown_ifKc
zzNewFlV1Nbs_cursor_PageLeftExtend_ifKc	{#insert zvCMD_ABRV_1C_sfPageLeftExtend}{#insert {#COND -if {#insert zzzHasAKCOrFrcTst_yes_M_cmd1} = yes -then zzzNoTestForCmdWKc_M_cmd1 -else z1slp}}	zzNewFlV1Nbs_cursor_PageLeftExtend_ifKc
zzNewFlV1Nbs_cursor_PageLeft_ifKc	{#insert zvCMD_ABRV_1C_sfPageLeft}{#insert {#COND -if {#insert zzzHasAKCOrFrcTst_yes_M_cmd1} = yes -then zzzNoTestForCmdWKc_M_cmd1 -else z1slp}}	zzNewFlV1Nbs_cursor_PageLeft_ifKc
zzNewFlV1Nbs_cursor_PageRightExtend_ifKc	{#insert zvCMD_ABRV_1C_sfPageRightExtend}{#insert {#COND -if {#insert zzzHasAKCOrFrcTst_yes_M_cmd1} = yes -then zzzNoTestForCmdWKc_M_cmd1 -else z1slp}}	zzNewFlV1Nbs_cursor_PageRightExtend_ifKc
zzNewFlV1Nbs_cursor_PageRight_ifKc	{#insert zvCMD_ABRV_1C_sfPageRight}{#insert {#COND -if {#insert zzzHasAKCOrFrcTst_yes_M_cmd1} = yes -then zzzNoTestForCmdWKc_M_cmd1 -else z1slp}}	zzNewFlV1Nbs_cursor_PageRight_ifKc
zzNewFlV1Nbs_cursor_PageUpExtend_ifKc	{#insert zvCMD_ABRV_1C_sfPageUpExtend}{#insert {#COND -if {#insert zzzHasAKCOrFrcTst_yes_M_cmd1} = yes -then zzzNoTestForCmdWKc_M_cmd1 -else z1slp}}	zzNewFlV1Nbs_cursor_PageUpExtend_ifKc
zzNewFlV1Nbs_cursor_PageUp_ifKc	{#insert zvCMD_ABRV_1C_sfPageUp}{#insert {#COND -if {#insert zzzHasAKCOrFrcTst_yes_M_cmd1} = yes -then zzzNoTestForCmdWKc_M_cmd1 -else z1slp}}	zzNewFlV1Nbs_cursor_PageUp_ifKc
zzNewFlV1Nbs_cursor_ParaDownExtend_ifKc	{#insert zvCMD_ABRV_1C_sfParaDownExtend}{#insert {#COND -if {#insert zzzHasAKCOrFrcTst_yes_M_cmd1} = yes -then zzzNoTestForCmdWKc_M_cmd1 -else z1slp}}	zzNewFlV1Nbs_cursor_ParaDownExtend_ifKc
zzNewFlV1Nbs_cursor_ParaDown_ifKc	{#insert zvCMD_ABRV_1C_sfParaDown}{#insert {#COND -if {#insert zzzHasAKCOrFrcTst_yes_M_cmd1} = yes -then zzzNoTestForCmdWKc_M_cmd1 -else z1slp}}	zzNewFlV1Nbs_cursor_ParaDown_ifKc
zzNewFlV1Nbs_cursor_ParaUpExtend_ifKc	{#insert zvCMD_ABRV_1C_sfParaUpExtend}{#insert {#COND -if {#insert zzzHasAKCOrFrcTst_yes_M_cmd1} = yes -then zzzNoTestForCmdWKc_M_cmd1 -else z1slp}}	zzNewFlV1Nbs_cursor_ParaUpExtend_ifKc
zzNewFlV1Nbs_cursor_ParaUp_ifKc	{#insert zvCMD_ABRV_1C_sfParaUp}{#insert {#COND -if {#insert zzzHasAKCOrFrcTst_yes_M_cmd1} = yes -then zzzNoTestForCmdWKc_M_cmd1 -else z1slp}}	zzNewFlV1Nbs_cursor_ParaUp_ifKc
zzNewFlV1Nbs_cursor_TabLeft_ifKc	{#insert zvCMD_ABRV_1C_sfTabLeft}{#insert {#COND -if {#insert zzzHasAKCOrFrcTst_yes_M_cmd1} = yes -then zzzNoTestForCmdWKc_M_cmd1 -else z1slp}}	zzNewFlV1Nbs_cursor_TabLeft_ifKc
zzNewFlV1Nbs_cursor_ViewEnd_ifKc	{#insert zvCMD_ABRV_1C_sfViewEnd}{#insert {#COND -if {#insert zzzHasAKCOrFrcTst_yes_M_cmd1} = yes -then zzzNoTestForCmdWKc_M_cmd1 -else z1slp}}	zzNewFlV1Nbs_cursor_ViewEnd_ifKc
zzNewFlV1Nbs_cursor_ViewStart_ifKc	{#insert zvCMD_ABRV_1C_sfViewStart}{#insert {#COND -if {#insert zzzHasAKCOrFrcTst_yes_M_cmd1} = yes -then zzzNoTestForCmdWKc_M_cmd1 -else z1slp}}	zzNewFlV1Nbs_cursor_ViewStart_ifKc
zzNewFlV1Nbs_cursor_WordLeftEndExtend_ifKc	{#insert zvCMD_ABRV_1C_sfWordLeftEndExtend}{#insert {#COND -if {#insert zzzHasAKCOrFrcTst_yes_M_cmd1} = yes -then zzzNoTestForCmdWKc_M_cmd1 -else z1slp}}	zzNewFlV1Nbs_cursor_WordLeftEndExtend_ifKc
zzNewFlV1Nbs_cursor_WordLeftEnd_ifKc	{#insert zvCMD_ABRV_1C_sfWordLeftEnd}{#insert {#COND -if {#insert zzzHasAKCOrFrcTst_yes_M_cmd1} = yes -then zzzNoTestForCmdWKc_M_cmd1 -else z1slp}}	zzNewFlV1Nbs_cursor_WordLeftEnd_ifKc
zzNewFlV1Nbs_cursor_WordLeftExtend_ifKc	{#insert zvCMD_ABRV_1C_sfWordLeftExtend}{#insert zzzNoVerificationForBtstrpsDlg_M_cmd1}	zzNewFlV1Nbs_cursor_WordLeftExtend_ifKc
zzNewFlV1Nbs_cursor_WordLeft_ifKc	{#insert zvCMD_ABRV_1C_sfWordLeft}{#insert {#COND -if {#insert zzzHasAKCOrFrcTst_yes_M_cmd1} = yes -then zzzNoTestForCmdWKc_M_cmd1 -else z1slp}}	zzNewFlV1Nbs_cursor_WordLeft_ifKc
zzNewFlV1Nbs_cursor_WordRightEndExtend_ifKc	{#insert zvCMD_ABRV_1C_sfWordRightEndExtend}{#insert zzzNoVerificationForBtstrpsDlg_M_cmd1}	zzNewFlV1Nbs_cursor_WordRightEndExtend_ifKc
zzNewFlV1Nbs_cursor_WordRightEnd_ifKc	{#insert zvCMD_ABRV_1C_sfWordRightEnd}{#insert zzzNoVerificationForBtstrpsDlg_M_cmd1}	zzNewFlV1Nbs_cursor_WordRightEnd_ifKc
zzNewFlV1Nbs_cursor_WordRightExtend_ifKc	{#insert zvCMD_ABRV_1C_sfWordRightExtend}{#insert {#COND -if {#insert zzzHasAKCOrFrcTst_yes_M_cmd1} = yes -then zzzNoTestForCmdWKc_M_cmd1 -else z1slp}}	zzNewFlV1Nbs_cursor_WordRightExtend_ifKc
zzNewFlV1Nbs_cursor_WordRight_ifKc	{#insert zvCMD_ABRV_1C_sfWordRight}{#insert {#COND -if {#insert zzzHasAKCOrFrcTst_yes_M_cmd1} = yes -then zzzNoTestForCmdWKc_M_cmd1 -else z1slp}}	zzNewFlV1Nbs_cursor_WordRight_ifKc
