fkgpr -- fkgr, no post-</A> params	{#insert zzjlCodeOffPrekOff}{#insert zzjlPRPCutSaveFuncNmIsL1wFileSuperDirPrompt}{#insert zzjlDispFuncPAPES_MSTR_dapnUrlParams}	fkgpr
fkgprk -- fkgrk, no post-</A> params	{#insert zzjlCodeOffPrekVb4c}{#insert zzjlPRPCutSaveFuncNmIsL1wFileSuperDirPrompt}{#insert zzjlDispFuncPAPES_MSTR_dapnUrlParams}	fkgprk
fkgr -- fkg, target is super-class	{#insert zzjlCodeOffPrekOff}{#insert zzjlPRPCutSaveFuncNmIsL1wFileSuperDirPrompt}{#insert zzjlDispFuncPAPAreUrlP_MSTR_dapnUrlParamsDaptPAP}	fkgr
fkgrc -- fkgr, CODE-d	{#insert zzjlCodeOnPrekOff}{#insert zzjlPRPCutSaveFuncNmIsL1wFileSuperDirPrompt}{#insert zzjlDispFuncPAPAreUrlP_MSTR_dapnUrlParamsDaptPAP}	fkgrc
fkgrck -- fkgrc, with prek abrv b4 cursor	{#insert zzjlCodeOnPrekVb4c}{#insert zzjlPRPCutSaveFuncNmIsL1wFileSuperDirPrompt}{#insert zzjlDispFuncPAPAreUrlP_MSTR_dapnUrlParamsDaptPAP}	fkgrck
fkgrk -- fkgr, with prek abrv b4 cursor	{#insert zzjlCodeOffPrekVb4c}{#insert zzjlPRPCutSaveFuncNmIsL1wFileSuperDirPrompt}{#insert zzjlDispFuncPAPAreUrlP_MSTR_dapnUrlParamsDaptPAP}	fkgrk
fkgrv -- fkgr, with post-</A> params type-abbreViations	{#insert zzjlCodeOffPrekOff}{#insert zzjlPRPCutSaveFuncNmIsL1wFileSuperDirPrompt}{#insert zzjlDispFuncPAPAreUrlP_MSTR_dapnUrlParamsDapnvPAP}	fkgrv
fkgrvc -- fkgrv, CODE-d	{#insert zzjlCodeOnPrekOff}{#insert zzjlPRPCutSaveFuncNmIsL1wFileSuperDirPrompt}{#insert zzjlDispFuncPAPAreUrlP_MSTR_dapnUrlParamsDapnvPAP}	fkgrvc
fkgrvck -- fkgrvc, with prek abrv b4 cursor	{#insert zzjlCodeOnPrekVb4c}{#insert zzjlPRPCutSaveFuncNmIsL1wFileSuperDirPrompt}{#insert zzjlDispFuncPAPAreUrlP_MSTR_dapnUrlParamsDapnvPAP}	fkgrvck
fkgrvk -- fkgrv, with prek abrv b4 cursor	{#insert zzjlCodeOffPrekVb4c}{#insert zzjlPRPCutSaveFuncNmIsL1wFileSuperDirPrompt}{#insert zzjlDispFuncPAPAreUrlP_MSTR_dapnUrlParamsDapnvPAP}	fkgrvk
fkpbr -- fkpb, target file is super-class	{#insert zzjlCodeOffPrekOff}{#insert zzjlFuncNmIsCBPRPCutSaveFileSuperDirPrompt}{#insert zzjlDispFuncPAPAreUrlP_MSTR_dapnUrlParamsDaptPAP}	fkpbr
fkpbrc -- fkpbr, CODE-d	{#insert zzjlCodeOnPrekOff}{#insert zzjlFuncNmIsCBPRPCutSaveFileSuperDirPrompt}{#insert zzjlDispFuncPAPAreUrlP_MSTR_dapnUrlParamsDaptPAP}	fkpbrc
fkpbrck -- fkpbrc, prek abrv b4 cursor	{#insert zzjlCodeOnPrekVb4c}{#insert zzjlFuncNmIsCBPRPCutSaveFileSuperDirPrompt}{#insert zzjlDispFuncPAPAreUrlP_MSTR_dapnUrlParamsDaptPAP}	fkpbrck
fkpbrk -- fkpbr, prek abrv b4 cursor	{#insert zzjlCodeOffPrekVb4c}{#insert zzjlFuncNmIsCBPRPCutSaveFileSuperDirPrompt}{#insert zzjlDispFuncPAPAreUrlP_MSTR_dapnUrlParamsDaptPAP}	fkpbrk
fkpbrv -- fkpbr, post-</A> params type-abbreViations	{#insert zzjlCodeOffPrekOff}{#insert zzjlFuncNmIsCBPRPCutSaveFileSuperDirPrompt}{#insert zzjlDispFuncPAPAreUrlP_MSTR_dapnUrlParamsDapnvPAP}	fkpbrv
fkpbrvc -- fkpbrv, CODE-d	{#insert zzjlCodeOnPrekOff}{#insert zzjlFuncNmIsCBPRPCutSaveFileSuperDirPrompt}{#insert zzjlDispFuncPAPAreUrlP_MSTR_dapnUrlParamsDapnvPAP}	fkpbrvc
fkpbrvck -- fkpbrvc, prek abrv b4 cursor	{#insert zzjlCodeOnPrekVb4c}{#insert zzjlFuncNmIsCBPRPCutSaveFileSuperDirPrompt}{#insert zzjlDispFuncPAPAreUrlP_MSTR_dapnUrlParamsDapnvPAP}	fkpbrvck
fkpbrvk -- fkpbrv, prek abrv b4 cursor	{#insert zzjlCodeOffPrekVb4c}{#insert zzjlFuncNmIsCBPRPCutSaveFileSuperDirPrompt}{#insert zzjlDispFuncPAPAreUrlP_MSTR_dapnUrlParamsDapnvPAP}	fkpbrvk
fkppbr -- fkpbr, no post-</A> params	{#insert zzjlCodeOffPrekOff}{#insert zzjlFuncNmIsCBPRPCutSaveFileSuperDirPrompt}{#insert zzjlDispFuncPAPES_MSTR_dapnUrlParams}	fkppbr
fkppbrk -- fkpbrk, no post-</A> params	{#insert zzjlCodeOffPrekVb4c}{#insert zzjlFuncNmIsCBPRPCutSaveFileSuperDirPrompt}{#insert zzjlDispFuncPAPES_MSTR_dapnUrlParams}	fkppbrk
fkppr -- fkpr, no post-</A> params	{#insert zzjlCodeOffPrekOff}{#insert zzjlPRPCutSaveFileSuperDirPrompt}{#insert zzjlDispFuncPAPES_MSTR_dapnUrlParams}	fkppr
fkpprk -- fkprk, no post-</A> params	{#insert zzjlCodeOffPrekVb4c}{#insert zzjlPRPCutSaveFileSuperDirPrompt}{#insert zzjlDispFuncPAPES_MSTR_dapnUrlParams}	fkpprk
fkpr -- fkp, target is super-class	{#insert zzjlCodeOffPrekOff}{#insert zzjlPRPCutSaveFileSuperDirPrompt}{#insert zzjlDispFuncPAPAreUrlP_MSTR_dapnUrlParamsDaptPAP}	fkpr
fkprc -- fkpr, CODE-d	{#insert zzjlCodeOnPrekOff}{#insert zzjlPRPCutSaveFileSuperDirPrompt}{#insert zzjlDispFuncPAPAreUrlP_MSTR_dapnUrlParamsDaptPAP}	fkprc
fkprck -- fkprc, prek abrv b4 cursor	{#insert zzjlCodeOnPrekVb4c}{#insert zzjlPRPCutSaveFileSuperDirPrompt}{#insert zzjlDispFuncPAPAreUrlP_MSTR_dapnUrlParamsDaptPAP}	fkprck
fkprk -- fkpr, prek abrv b4 cursor	{#insert zzjlCodeOffPrekVb4c}{#insert zzjlPRPCutSaveFileSuperDirPrompt}{#insert zzjlDispFuncPAPAreUrlP_MSTR_dapnUrlParamsDaptPAP}	fkprk
fkprv -- fkpr, post-</A> params type-abbreViations	{#insert zzjlCodeOffPrekOff}{#insert zzjlPRPCutSaveFileSuperDirPrompt}{#insert zzjlDispFuncPAPAreUrlP_MSTR_dapnUrlParamsDapnvPAP}	fkprv
fkprvc -- fkprv, CODE-d	{#insert zzjlCodeOnPrekOff}{#insert zzjlPRPCutSaveFileSuperDirPrompt}{#insert zzjlDispFuncPAPAreUrlP_MSTR_dapnUrlParamsDapnvPAP}	fkprvc
fkprvck -- fkprvc, prek abrv b4 cursor	{#insert zzjlCodeOnPrekVb4c}{#insert zzjlPRPCutSaveFileSuperDirPrompt}{#insert zzjlDispFuncPAPAreUrlP_MSTR_dapnUrlParamsDapnvPAP}	fkprvck
fkprvk -- fkprv, prek abrv b4 cursor	{#insert zzjlCodeOffPrekVb4c}{#insert zzjlPRPCutSaveFileSuperDirPrompt}{#insert zzjlDispFuncPAPAreUrlP_MSTR_dapnUrlParamsDapnvPAP}	fkprvk
