__XBN-PhraseExpress is released under the LGPL 2.1	(*XBN-PhraseExpress: Large set of generically useful scripting tools for MS Windows, written in PhraseExpress and TextPad.  //  Copyright (C) 2013 Jeff Epstein  //  This library is free software; you can redistribute it and/or modify it under the terms of the GNU Lesser General Public License as published by the Free Software Foundation; either version 2.1 of the License, or (at your option) any later version.  //  This library is distributed in the hope that it will be useful, but WITHOUT ANY WARRANTY; without even the implied warranty of MERCHANTABILITY or FITNESS FOR A PARTICULAR PURPOSE. See the GNU Lesser General Public License for more details.  //  You should have received a copy of the GNU Lesser General Public License along with this library; if not, write to the Free Software Foundation, Inc., 51 Franklin Street, Fifth Floor, Boston, MA 02110-1301 USA*)		(*Two tabs plus this comment, to force this phrase to be (a) imported, and (b) with NO autotext*)
zTPBookmarkCopyAllEsc	\\\{#insert zCASpEE\\\}	zTPBookmarkCopyAllEsc
zTPBookmarkCopyAllTPKeys	Ctrl+Shift+Alt+E	zTPBookmarkCopyAllTPKeys
zTPBookmarkCutAllEsc	\\\{#insert zCASpWW\\\}	zTPBookmarkCutAllEsc
zTPBookmarkCutAllTPKeys	Ctrl+Shift+Alt+W	zTPBookmarkCutAllTPKeys
zTPBookmarkGTNextEsc	\\\{#insert zF2\\\}\\\{#sleep 100\\\}	zTPBookmarkGTNextEsc
zTPBookmarkGTNextTPKeys	F2	zTPBookmarkGTNextTPKeys
zTPBookmarkToggleEsc	\\\{#insert zCpF2\\\}\\\{#sleep 10\\\}	zTPBookmarkToggleEsc
zTPBookmarkToggleTPKeys	Ctrl+F2	zTPBookmarkToggleTPKeys
zTPFFindDlgOpenEsc	\\\{#insert zCpF5\\\}\\\{#sleep 50\\\}	zTPFFindDlgOpenEsc
zTPFFindDlgOpenTPKeys	Ctrl+F5	zTPFFindDlgOpenTPKeys
zTPFileManagerEsc	\\\{#insert F3\\\}\\\{#sleep 50\\\}	zTPFileManagerEsc
zTPFileManagerTPKeys	F3	zTPFileManagerTPKeys
zTPFileOpenEsc	\\\{#insert zCpOO\\\}\\\{#sleep 1750\\\}	zTPFileOpenEsc
zTPFileOpenTPKeys	Ctrl+O	zTPFileOpenTPKeys
zTPFileQOpenEsc	\\\{#insert zCSpOO\\\}\\\{#sleep 50\\\}	zTPFileQOpenEsc
zTPFileQOpenTPKeys	Ctrl+Shift+O	zTPFileQOpenTPKeys
zTPFindDlgOpenEsc	\\\{#insert zF5\\\}\\\{#sleep 50\\\}	zTPFindDlgOpenEsc
zTPFindDlgOpenTPKeys	F5	zTPFindDlgOpenTPKeys
zTPFindNextEsc	\\\{#insert zCpFF\\\}\\\{#sleep 15\\\}	zTPFindNextEsc
zTPFindNextTPKeys	Ctrl+F	zTPFindNextTPKeys
zTPGTDlgOpenEsc	\\\{#insert zCpGG\\\}\\\{#sleep 50\\\}	zTPGTDlgOpenEsc
zTPGTDlgOpenTPKeys	Ctrl+G	zTPGTDlgOpenTPKeys
zTPPrefsDlgOpenEsc	\\\{#insert zCpQQ\\\}\\\{#sleep 25\\\}\\\{#insert zPP\\\}\\\{#sleep 50\\\}	zTPPrefsDlgOpenEsc
zTPPrefsDlgOpenTPKeys	Ctrl+Q, P	zTPPrefsDlgOpenTPKeys
zTPRplcDlgOpenEsc	\\\{#insert zF8\\\}\\\{#sleep 50\\\}	zTPRplcDlgOpenEsc
zTPRplcDlgOpenTPKeys	F8	zTPRplcDlgOpenTPKeys
