krx -- There is no krx, because it's logically NOTHING	{#MSGBOX -head 'krx' not applicable -text There is no 'krx'. At least one character must follow 'krx'. See: krxinfo, krksyn}	krx
krxa -- Alt modifier with NOTHING MODIFIED: {#ALT ...}	{#insert zvESC_LVL_CNT_st0}{#insert zKrxaRAW_M_elc}{#insert krksyn}	krxa
krxal -- {#ALT {#LWIN ...}}	{#insert zvESC_LVL_CNT_st0}{#insert zKrxalRAW_M_elc}{#insert krksyn}	krxal
krxalp -- krxal, escaped	{#insert zvESC_LVL_CNT_st1}{#insert zKrxalRAW_M_elc}{#insert krksyn}	krxalp
krxalq -- krxal, doubly-escaped (or more)	{#insert zvESC_LVL_CNT_stPrompt}{#insert zKrxalRAW_M_elc}{#insert krksyn}	krxalq
krxap -- krxa, escaped	{#insert zvESC_LVL_CNT_st1}{#insert zKrxaRAW_M_elc}{#insert krksyn}	krxap
krxaq -- krxa, doubly-escaped (or more)	{#insert zvESC_LVL_CNT_stPrompt}{#insert zKrxaRAW_M_elc}{#insert krksyn}	krxaq
krxas -- {#ALT {#SHIFT ...}}	{#insert zvESC_LVL_CNT_st0}{#insert zKrxasRAW_M_elc}{#insert krksyn}	krxas
krxasl -- {#ALT {#SHIFT {#LWIN ...}}}	{#insert zvESC_LVL_CNT_st0}{#insert zKrxaslRAW_M_elc}{#insert krksyn}	krxasl
krxaslp -- krxasl, escaped	{#insert zvESC_LVL_CNT_st1}{#insert zKrxaslRAW_M_elc}{#insert krksyn}	krxaslp
krxaslq -- krxasl, doubly-escaped (or more)	{#insert zvESC_LVL_CNT_stPrompt}{#insert zKrxaslRAW_M_elc}{#insert krksyn}	krxaslq
krxasp -- krxas, escaped	{#insert zvESC_LVL_CNT_st1}{#insert zKrxasRAW_M_elc}{#insert krksyn}	krxasp
krxasq -- krxas, doubly-escaped (or more)	{#insert zvESC_LVL_CNT_stPrompt}{#insert zKrxasRAW_M_elc}{#insert krksyn}	krxasq
krxc -- {#CTRL ...}	{#insert zvESC_LVL_CNT_st0}{#insert zKrxcRAW_M_elc}{#insert krksyn}	krxc
krxca -- {#CTRL {#ALT ...}}	{#insert zvESC_LVL_CNT_st0}{#insert zKrxcaRAW_M_elc}{#insert krksyn}	krxca
krxcal -- {#CTRL {#ALT {#LWIN ...}}}	{#insert zvESC_LVL_CNT_st0}{#insert zKrxcalRAW_M_elc}{#insert krksyn}	krxcal
krxcalp -- krxcal, escaped	{#insert zvESC_LVL_CNT_st1}{#insert zKrxcalRAW_M_elc}{#insert krksyn}	krxcalp
krxcalq -- krxcal, doubly-escaped (or more)	{#insert zvESC_LVL_CNT_stPrompt}{#insert zKrxcalRAW_M_elc}{#insert krksyn}	krxcalq
krxcap -- krxca, escaped	{#insert zvESC_LVL_CNT_st1}{#insert zKrxcaRAW_M_elc}{#insert krksyn}	krxcap
krxcaq -- krxca, doubly-escaped (or more)	{#insert zvESC_LVL_CNT_stPrompt}{#insert zKrxcaRAW_M_elc}{#insert krksyn}	krxcaq
krxcas -- {#CTRL {#ALT {#SHIFT ...}}}	{#insert zvESC_LVL_CNT_st0}{#insert zKrxcasRAW_M_elc}{#insert krksyn}	krxcas
krxcasl -- {#CTRL {#ALT {#SHIFT {#LWIN ...}}}}	{#insert zvESC_LVL_CNT_st0}{#insert zKrxcaslRAW_M_elc}{#insert krksyn}	krxcasl
krxcaslp -- krxcasl, escaped	{#insert zvESC_LVL_CNT_st1}{#insert zKrxcaslRAW_M_elc}{#insert krksyn}	krxcaslp
krxcaslq -- krxcasl, doubly-escaped (or more)	{#insert zvESC_LVL_CNT_stPrompt}{#insert zKrxcaslRAW_M_elc}{#insert krksyn}	krxcaslq
krxcasp -- krxcas, escaped	{#insert zvESC_LVL_CNT_st1}{#insert zKrxcasRAW_M_elc}{#insert krksyn}	krxcasp
krxcasq -- krxcas, doubly-escaped (or more)	{#insert zvESC_LVL_CNT_stPrompt}{#insert zKrxcasRAW_M_elc}{#insert krksyn}	krxcasq
krxcl -- {#CTRL {#LWIN ...}}	{#insert zvESC_LVL_CNT_st0}{#insert zKrxclRAW_M_elc}{#insert krksyn}	krxcl
krxclp -- krxcl, escaped	{#insert zvESC_LVL_CNT_st1}{#insert zKrxclRAW_M_elc}{#insert krksyn}	krxclp
krxclq -- krxcl, doubly-escaped (or more)	{#insert zvESC_LVL_CNT_stPrompt}{#insert zKrxclRAW_M_elc}{#insert krksyn}	krxclq
krxcp -- krxc, escaped	{#insert zvESC_LVL_CNT_st1}{#insert zKrxcRAW_M_elc}{#insert krksyn}	krxcp
krxcq -- krxc, doubly-escaped (or more)	{#insert zvESC_LVL_CNT_stPrompt}{#insert zKrxcRAW_M_elc}{#insert krksyn}	krxcq
krxcs -- {#CTRL {#SHIFT ...}}	{#insert zvESC_LVL_CNT_st0}{#insert zKrxcsRAW_M_elc}{#insert krksyn}	krxcs
krxcsl -- {#CTRL {#SHIFT {#LWIN ...}}}	{#insert zvESC_LVL_CNT_st0}{#insert zKrxcslRAW_M_elc}{#insert krksyn}	krxcsl
krxcslp -- krxcsl, escaped	{#insert zvESC_LVL_CNT_st1}{#insert zKrxcslRAW_M_elc}{#insert krksyn}	krxcslp
krxcslq -- krxcsl, doubly-escaped (or more)	{#insert zvESC_LVL_CNT_stPrompt}{#insert zKrxcslRAW_M_elc}{#insert krksyn}	krxcslq
krxcsp -- krxcs, escaped	{#insert zvESC_LVL_CNT_st1}{#insert zKrxcsRAW_M_elc}{#insert krksyn}	krxcsp
krxcsq -- krxcs, doubly-escaped (or more)	{#insert zvESC_LVL_CNT_stPrompt}{#insert zKrxcsRAW_M_elc}{#insert krksyn}	krxcsq
krxl -- {#LWIN ...}	{#insert zvESC_LVL_CNT_st0}{#insert zKrxlRAW_M_elc}{#insert krksyn}	krxl
krxlp -- krxl, escaped	{#insert zvESC_LVL_CNT_st1}{#insert zKrxlRAW_M_elc}{#insert krksyn}	krxlp
krxlq -- krxl, doubly-escaped (or more)	{#insert zvESC_LVL_CNT_stPrompt}{#insert zKrxlRAW_M_elc}{#insert krksyn}	krxlq
krxs -- {#SHIFT ...}	{#insert zvESC_LVL_CNT_st0}{#insert zKrxsRAW_M_elc}{#insert krksyn}	krxs
krxsl -- {#SHIFT {#LWIN ...}}	{#insert zvESC_LVL_CNT_st0}{#insert zKrxslRAW_M_elc}{#insert krksyn}	krxsl
krxslp -- krxsl, escaped	{#insert zvESC_LVL_CNT_st1}{#insert zKrxslRAW_M_elc}{#insert krksyn}	krxslp
krxslq -- krxsl, doubly-escaped (or more)	{#insert zvESC_LVL_CNT_stPrompt}{#insert zKrxslRAW_M_elc}{#insert krksyn}	krxslq
krxsp -- krxs, escaped	{#insert zvESC_LVL_CNT_st1}{#insert zKrxsRAW_M_elc}{#insert krksyn}	krxsp
krxsq -- krxs, doubly-escaped (or more)	{#insert zvESC_LVL_CNT_stPrompt}{#insert zKrxsRAW_M_elc}{#insert krksyn}	krxsq
zKrxaRAW_M_elc -- Needs zvESC_LVL_CNT (assumed good value!)	{#insert zOY_M_elc}#ALT {#insert zCY_M_elc}{#insert zzLeftPrevEscCrly_M_elc}	zKrxaRAW_M_elc
zKrxalRAW_M_elc	{#insert zOY_M_elc}#ALT {#insert zOY_M_elc}#LWIN {#insert zCYx2_M_elc}{#insert zzLeftPrevEscCrlyX2_M_elc}	zKrxalRAW_M_elc
zKrxasRAW_M_elc	{#insert zOY_M_elc}#ALT {#insert zOY_M_elc}#SHIFT {#insert zCYx2_M_elc}{#insert zzLeftPrevEscCrlyX2_M_elc}	zKrxasRAW_M_elc
zKrxaslRAW_M_elc	{#insert zOY_M_elc}#ALT {#insert zOY_M_elc}#SHIFT {#insert zOY_M_elc}#LWIN {#insert zCYx3_M_elc}{#insert zzLeftPrevEscCrlyX3_M_elc}	zKrxaslRAW_M_elc
zKrxcRAW_M_elc	{#insert zOY_M_elc}#CTRL {#insert zCY_M_elc}{#insert zzLeftPrevEscCrly_M_elc}	zKrxcRAW_M_elc
zKrxcaRAW_M_elc	{#insert zOY_M_elc}#CTRL {#insert zOY_M_elc}#ALT {#insert zCYx2_M_elc}{#insert zzLeftPrevEscCrlyX2_M_elc}	zKrxcaRAW_M_elc
zKrxcalRAW_M_elc	{#insert zOY_M_elc}#CTRL {#insert zOY_M_elc}#ALT {#insert zOY_M_elc}#LWIN {#insert zCYx3_M_elc}{#insert zzLeftPrevEscCrlyX3_M_elc}	zKrxcalRAW_M_elc
zKrxcasRAW_M_elc	{#insert zOY_M_elc}#CTRL {#insert zOY_M_elc}#ALT {#insert zOY_M_elc}#SHIFT {#insert zCYx3_M_elc}{#insert zzLeftPrevEscCrlyX3_M_elc}	zKrxcasRAW_M_elc
zKrxcaslRAW_M_elc	{#insert zOY_M_elc}#CTRL {#insert zOY_M_elc}#ALT {#insert zOY_M_elc}#SHIFT {#insert zOY_M_elc}#LWIN {#insert zCYx4_M_elc}{#insert zzLeftPrevEscCrlyX4_M_elc}	zKrxcaslRAW_M_elc
zKrxclRAW_M_elc	{#insert zOY_M_elc}#CTRL {#insert zOY_M_elc}#LWIN {#insert zCYx2_M_elc}{#insert zzLeftPrevEscCrlyX2_M_elc}	zKrxclRAW_M_elc
zKrxcsRAW_M_elc	{#insert zOY_M_elc}#CTRL {#insert zOY_M_elc}#SHIFT {#insert zCYx2_M_elc}{#insert zzLeftPrevEscCrlyX2_M_elc}	zKrxcsRAW_M_elc
zKrxcslRAW_M_elc	{#insert zOY_M_elc}#CTRL {#insert zOY_M_elc}#SHIFT {#insert zOY_M_elc}#LWIN {#insert zCYx3_M_elc}{#insert zzLeftPrevEscCrlyX3_M_elc}	zKrxcslRAW_M_elc
zKrxlRAW_M_elc	{#insert zOY_M_elc}#LWIN {#insert zCY_M_elc}{#insert zzLeftPrevEscCrly_M_elc}	zKrxlRAW_M_elc
zKrxsRAW_M_elc	{#insert zOY_M_elc}#SHIFT {#insert zCY_M_elc}{#insert zzLeftPrevEscCrly_M_elc}	zKrxsRAW_M_elc
zKrxslRAW_M_elc	{#insert zOY_M_elc}#SHIFT {#insert zOY_M_elc}#LWIN {#insert zCYx2_M_elc}{#insert zzLeftPrevEscCrlyX2_M_elc}	zKrxslRAW_M_elc
zzKrxAllMainAbrvs1CQBL	[Krxa][Krxc][Krxl][Krxs][Krxal][Krxas][Krxca][Krxcl][Krxcs][Krxsl][Krxasl][Krxcal][Krxcas][Krxcsl][Krxcasl]	zzKrxAllMainAbrvs1CQBL
krxtestall	{#SETPHRASE -description zvQB_STR_LIST -content {#insert zzKrxAllMainAbrvs1CQBL} -autotext zvQB_STR_LIST -folder ctvv_folder}{#insert zzTestAllMainPhrsCrtrAbrvs_M_qbl}	krxtestall
krxinfo	{#BALLOON -title krx* info -text Example use: With '\\\{#ENTER\\\}' in the clipboard, execute 'krxca', then paste, resulting in: \\\{#CTRL \\\{#ALT \\\{#ENTER\\\}\\\}\\\}  //  There is no 'krx' phrase-creator, as that would logically output *nothing*.}
