papeg -- zHtmlEscJavaGenericsPostAllParams ALT KC	{#insert zHtmlEscJavaGenericsPostAllParams}	papeg
sgl	{#insert zzSetAngToL1cWycTo1}{#insert zzXPastePrevJFSigAtCrsrDelRqstdFrmParams_M_wycAng}{#insert zzSglsyn_M_yon}	sgl
sgl2	{#insert zzSetAngToL1cWycTo2}{#insert zzXPastePrevJFSigAtCrsrDelRqstdFrmParams_M_wycAng}{#insert zzSglsyn_M_yon}	sgl2
sgl3	{#insert zzSetAngToL1cWycTo3}{#insert zzXPastePrevJFSigAtCrsrDelRqstdFrmParams_M_wycAng}{#insert zzSglsyn_M_yon}	sgl3
sglc	{#insert zzSetAngToL1cWycTo1}{#insert zzXCddPastePrevJFSigAtCrsrDelRqstdFrmParams_M_wycAng}{#insert zzSglsyn_M_yon}	sglc
sglc2	{#insert zzSetAngToL1cWycTo2}{#insert zzXCddPastePrevJFSigAtCrsrDelRqstdFrmParams_M_wycAng}{#insert zzSglsyn_M_yon}	sglc2
sglc3	{#insert zzSetAngToL1cWycTo3}{#insert zzXCddPastePrevJFSigAtCrsrDelRqstdFrmParams_M_wycAng}{#insert zzSglsyn_M_yon}	sglc3
sglcn	{#insert zzSetAngToL1cWycToPrompt}{#insert zzXCddPastePrevJFSigAtCrsrDelRqstdFrmParams_M_wycAng}{#insert zzSglsyn_M_yon}	sglcn
sglkpsyn	{#BALLOON -title sg[l,z]*: What to keep in params? -text [a,A,n,g,G,u,v] declares what should be kept in the params. [a]=keep all (types, generics, names), [n]=names only // Types: [g]=w/ gnrcs, 'u'=w/o gnrcs for JavaDoc URL, 'v'=w/o gnrcs for display~only abrvs // capital=HTML~esc // Example: tsglc2 // sglsyn}	sglkpsyn
sgln	{#insert zzSetAngToL1cWycToPrompt}{#insert zzXPastePrevJFSigAtCrsrDelRqstdFrmParams_M_wycAng}{#insert zzSglsyn_M_yon}	sgln
sglsyn	{#BALLOON -title Syntax: Get~paste nxt/prv func~sig -text {#insert zzSglsyns1of2}  //  papeg=with crsr after close~paren, escape all gnrcs (see ysc*: rtlsyn)  //  [a,A,n,g,G,u,v]: sglkpsyn  //  {#insert zzSglOptSynTxt}}	sglsyn
zzSglsyns1of2	[a,A,n,g,G,u,v]sg[l,z][c][2~3,n]	zzSglsyns1of2
zzSglsyns2of2	papeg	zzSglsyns2of2

sgltestall	{#insert zzJavaTestIntroFileNew}{#insert zzzTstDupedSigLines}{#insert zTPGTDocTop}{#insert zvANGUV_stPrompt}{#insert zvANGUV}sgz{#insert zzzEnterAng2}{#insert sgz}{#insert zzzEnterAng2}sgz2{#insert zzzEnterAng2}{#insert sgz2}{#insert zzzEnterAng2}sgz3{#insert zzzEnterAng2}{#insert sgz3}{#insert zzzEnterAng2}sgzn{#insert zzzEnterAng2}{#insert sgzn}{#insert zzzEnterAng2}sgzc{#insert zzzEnterAng2}{#insert sgzc}{#insert zzzEnterAng2}sgzc2{#insert zzzEnterAng2}{#insert sgzc2}{#insert zzzEnterAng2}sgzc3{#insert zzzEnterAng2}{#insert sgzc3}{#insert zzzEnterAng2}sgzcn{#insert zzzEnterAng2}{#insert sgzcn}{#insert zTPGTDocBottom}{#insert zHOME}{#insert zzzTstAng2}sgl{#insert zzzEnterAng2}{#insert sgl}{#insert zzzEnterAng2}sgl2{#insert zzzEnterAng2}{#insert sgl2}{#insert zzzEnterAng2}sgl3{#insert zzzEnterAng2}{#insert sgl3}{#insert zzzEnterAng2}sgln{#insert zzzEnterAng2}{#insert sgln}{#insert zzzEnterAng2}sglc{#insert zzzEnterAng2}{#insert sglc}{#insert zzzEnterAng2}sglc2{#insert zzzEnterAng2}{#insert sglc2}{#insert zzzEnterAng2}sglc3{#insert zzzEnterAng2}{#insert sglc3}{#insert zzzEnterAng2}sglcn{#insert zzzEnterAng2}{#insert sglcn}{#insert zvSYNTAX_ON_stOn}{#insert zzSglsyn_M_yon}	sgltestall
sgz	{#insert zzSetAngToL1cWycTo1}{#insert zzXPasteNextJFSigAtCrsrDelRqstdFrmParams_M_wycAng}{#insert zzSglsyn_M_yon}	sgz
sgz2	{#insert zzSetAngToL1cWycTo2}{#insert zzXPasteNextJFSigAtCrsrDelRqstdFrmParams_M_wycAng}{#insert zzSglsyn_M_yon}	sgz2
sgz3	{#insert zzSetAngToL1cWycTo3}{#insert zzXPasteNextJFSigAtCrsrDelRqstdFrmParams_M_wycAng}{#insert zzSglsyn_M_yon}	sgz3
sgzc	{#insert zzSetAngToL1cWycTo1}{#insert zzXCddPasteNextJFSigAtCrsrDelRqstdFrmParams_M_wycAng}{#insert zzSglsyn_M_yon}	sgzc
sgzc2	{#insert zzSetAngToL1cWycTo2}{#insert zzXCddPasteNextJFSigAtCrsrDelRqstdFrmParams_M_wycAng}{#insert zzSglsyn_M_yon}	sgzc2
sgzc3	{#insert zzSetAngToL1cWycTo3}{#insert zzXCddPasteNextJFSigAtCrsrDelRqstdFrmParams_M_wycAng}{#insert zzSglsyn_M_yon}	sgzc3
sgzcn	{#insert zzSetAngToL1cWycToPrompt}{#insert zzXCddPasteNextJFSigAtCrsrDelRqstdFrmParams_M_wycAng}{#insert zzSglsyn_M_yon}	sgzcn
sgzn	{#insert zzSetAngToL1cWycToPrompt}{#insert zzXPasteNextJFSigAtCrsrDelRqstdFrmParams_M_wycAng}{#insert zzSglsyn_M_yon}	sgzn
zSelCopyPrvNxtJFSigReturnToXCursorCdd_M_gpnWyc -- See zSelCopyPrvNxtJFSigReturnToXCursor_M_gpnWyc	{#insert zXCddSelCopyPrvNxtJFSig_M_gpnWyc}{#insert zzXUpDownOppositeDir_M_gpn}	zSelCopyPrvNxtJFSigReturnToXCursorCdd_M_gpnWyc
zXCddSelCopyPrvNxtJFSig_M_gpnWyc -*-	{#insert zXmarkCoded}{#insert zSelCopyPrvNxtJFSig_M_gpnWyc}	zXCddSelCopyPrvNxtJFSig_M_gpnWyc
zzPasteParamsKeepDelRqstd_M_ang -- Needs zvANGUV	{#insert zTPPaste}{#insert zPostAllParamsKeepDelRqstd_M_ang}	zzPasteParamsKeepDelRqstd_M_ang
zzXCddPasteNextJFSigAtCrsrDelRqstdFrmParams_M_wycAng	{#insert zvGPRV_NXT_stNext}{#insert zzXCddPastePrvNxtJFSigAtCrsrDelRqstdFrmParams_M_gpnWycAng}	zzXCddPasteNextJFSigAtCrsrDelRqstdFrmParams_M_wycAng
zzXCddPastePrevJFSigAtCrsrDelRqstdFrmParams_M_wycAng	{#insert zvGPRV_NXT_stPrev}{#insert zzXCddPastePrvNxtJFSigAtCrsrDelRqstdFrmParams_M_gpnWycAng}	zzXCddPastePrevJFSigAtCrsrDelRqstdFrmParams_M_wycAng
zzXCddPastePrvNxtJFSigAtCrsrDelRqstdFrmParams_M_gpnWycAng	{#insert zSelCopyPrvNxtJFSigReturnToXCursorCdd_M_gpnWyc}{#insert zzPasteParamsKeepDelRqstd_M_ang}{#insert zzEscGnrcsIfAngNotLCGPreBrktGTP}	zzXCddPastePrvNxtJFSigAtCrsrDelRqstdFrmParams_M_gpnWycAng
zzXPasteNextJFSigAtCrsrDelRqstdFrmParams_M_wycAng	{#insert zvGPRV_NXT_stNext}{#insert zSelCopyPrvNxtJFSigReturnToXCursor_M_gpnWyc}{#insert zzPasteParamsKeepDelRqstd_M_ang}	zzXPasteNextJFSigAtCrsrDelRqstdFrmParams_M_wycAng
zzXPastePrevJFSigAtCrsrDelRqstdFrmParams_M_wycAng	{#insert zvGPRV_NXT_stPrev}{#insert zSelCopyPrvNxtJFSigReturnToXCursor_M_gpnWyc}{#insert zzPasteParamsKeepDelRqstd_M_ang}	zzXPastePrevJFSigAtCrsrDelRqstdFrmParams_M_wycAng
