__XBN-PhraseExpress is released under the LGPL 2.1	(*XBN-PhraseExpress is a large set of generically-useful Microsoft Windows scripting tools, written in PhraseExpress, using the plain-text editor TextPad as its foundation.  //  Copyright (C) 2013 Jeff Epstein  //  This library is free software; you can redistribute it and/or modify it under the terms of the GNU Lesser General Public License as published by the Free Software Foundation; either version 2.1 of the License, or (at your option) any later version.  //  This library is distributed in the hope that it will be useful, but WITHOUT ANY WARRANTY; without even the implied warranty of MERCHANTABILITY or FITNESS FOR A PARTICULAR PURPOSE. See the GNU Lesser General Public License for more details.  //  You should have received a copy of the GNU Lesser General Public License along with this library; if not, write to the Free Software Foundation, Inc., 51 Franklin Street, Fifth Floor, Boston, MA 02110-1301 USA*)		(*Two tabs plus this comment, to force this phrase to be (a) imported, and (b) with NO autotext*)
gtk -- Func sig-line start	{#insert scpkflocal}{#insert gtcb}	gtk
gtkg -- func-name (siG start)	{#insert scpkflocal}{#insert gtcbg}	gtkg
gtkgprompt	{#insert gtkg}{#insert zCorrectFuncPrompt}	gtkgprompt
gtkm -- Func sig-line start	{#insert zYmark}{#insert gtk}	gtkm
gtkmc -- Func sig-line start	{#insert zYmarkCoded}{#insert gtk}	gtkmc
gtkmcg -- func-name (siG start)	{#insert zYmarkCoded}{#insert gtkg}	gtkmcg
gtkmcp -- Params (open paren)	{#insert zYmarkCoded}{#insert gtkp}	gtkmcp
gtkmcrg -- Return type	{#insert zYmarkCoded}{#insert gtkrg}	gtkmcrg
gtkmfprompt	{#insert gtkmf}{#insert zCorrectFuncPrompt}	gtkmfprompt
gtkmg -- func-name (siG start)	{#insert zYmark}{#insert gtkg}	gtkmg
gtkmgprompt	{#insert gtkmg}{#insert zCorrectFuncPrompt}	gtkmgprompt
gtkmp -- Params (open paren)	{#insert zYmark}{#insert gtkp}	gtkmp
gtkmpprompt	{#insert gtkmp}{#insert zCorrectFuncPrompt}	gtkmpprompt
gtkmrg -- Return type	{#insert zYmark}{#insert gtkrg}	gtkmrg
gtkmrgprompt	{#insert gtkmrg}{#insert zCorrectFuncPrompt}	gtkmrgprompt
gtkp -- Params (open paren)	{#insert scpkflocal}{#insert gtcbp}	gtkp
gtkpprompt	{#insert gtkp}{#insert zCorrectFuncPrompt}	gtkpprompt
gtkprompt	{#insert gtk}{#insert zCorrectFuncPrompt}	gtkprompt
gtkrg -- Return type	{#insert scpkflocal}{#insert gtcbrg}	gtkrg
gtkrgprompt	{#insert gtkrg}{#insert zCorrectFuncPrompt}	gtkrgprompt
scpkf -- Select-Copy Func-name from Prev linK (local or not)	{#insert zFindPrevLinkTagStartFDlg}.html#{#insert zFindBtnNext}{#insert zFindDlgClose}{#insert zRIGHT}{#insert zSelectR1wCopy}	scpkf
scpkflocal -- Select-Copy LOCAL Func-name from Prev linK	{#insert zFindOpenUpMC}HREF={#asc 34}#{#insert zFindGoMCClose}{#insert zRIGHT}{#insert zSelectR1wCopy}{#sleep 500}	scpkflocal
scpkg -- func-name (siG start)	{#insert scpkflocal}{#insert sccbg}	scpkg
scpkgprompt	{#insert scpkg}{#insert zCorrectFuncPrompt}	scpkgprompt
scpkmcg -- func-name (siG start)	{#insert zYmarkCoded}{#insert scpkg}	scpkmcg
scpkmcgprompt	{#insert scpkmcg}{#insert zCorrectFuncPrompt}	scpkmcgprompt
scpkmcp -- Params (open paren)	{#insert zYmarkCoded}{#insert scpkp}	scpkmcp
scpkmcpprompt	{#insert scpkmcp}{#insert zCorrectFuncPrompt}	scpkmcpprompt
scpkmcrg -- Return type	{#insert zYmarkCoded}{#insert scpkrg}	scpkmcrg
scpkmcrgprompt	{#insert scpkmcrg}{#insert zCorrectFuncPrompt}	scpkmcrgprompt
scpkmg -- func-name (siG start)	{#insert zYmark}{#insert scpkg}	scpkmg
scpkmgprompt	{#insert scpkmg}{#insert zCorrectFuncPrompt}	scpkmgprompt
scpkmp -- Params (open paren)	{#insert zYmark}{#insert scpkp}	scpkmp
scpkmpprompt	{#insert scpkmp}{#insert zCorrectFuncPrompt}	scpkmpprompt
scpkmrg -- Return type	{#insert zYmark}{#insert scpkrg}	scpkmrg
scpkmrgprompt	{#insert scpkmrg}{#insert zCorrectFuncPrompt}	scpkmrgprompt
scpkp -- Params (open paren)	{#insert scpkflocal}{#insert sccbp}	scpkp
scpkpprompt	{#insert scpkpp}{#insert zCorrectFuncPrompt}	scpkpprompt
scpkrg -- Return type	{#insert scpkflocal}{#insert sccbrg}	scpkrg
scpkrgprompt	{#insert scpkrg}{#insert zCorrectFuncPrompt}	scpkrgprompt
scpku -- Select-Copy entire Url from Prev-linK	{#insert zFindPrevLinkTagStartFDlg}{#insert zFindFlagRETglRAW}[^{#asc 34}]+{#asc 34}{#insert zFindGoREClose}{#insert zTPSelectL1c}	scpku
sprcnstrsigpl -- super-cnstr signature w/ params from prev siG	{#insert cnsuper}{#insert mwpl}	sprcnstrsigpl
sprcnstrsigpz -- super-cnstr signature w/ params from next siG	{#insert cnsuper}{#insert mwpz}	sprcnstrsigpz
mwcpkg -- mwpkg CODE-d	{#insert scpkmcgprompt}{#insert zYDownUp}	mwcpkg
mwcpkgn -- mwpkg CODE-d	{#insert scpkmcgprompt}{#insert zYDownUp}{#insert dapt}	mwcpkgn
mwcpkgt -- mwpkg CODE-d	{#insert scpkmcgprompt}{#insert zYDownUp}{#insert dapn}	mwcpkgt
mwcpkgy -- mwpkg CODE-d	{#insert scpkmcgprompt}{#insert zYDownUp}{#insert dapn}	mwcpkgy
mwcpkmrg -- mwpkmrg CODE-d	{#insert scpkmcrgprompt}{#insert zYDownUp}	mwcpkrg
mwcpkmrgn -- mwpkmrg CODE-d	{#insert scpkmcrgprompt}{#insert zYDownUp}{#insert dapt}	mwcpkmrgn
mwcpkmrgt -- mwpkmrg CODE-d	{#insert scpkmcrgprompt}{#insert zYDownUp}{#insert dapn}	mwcpkmrgt
mwcpkmrgy -- mwpkmrg CODE-d	{#insert scpkmcrgprompt}{#insert zYDownUp}{#insert dapn}	mwcpkmrgy
mwcpkp --  mwpkp CODE-d	{#insert scpkmcpprompt}{#insert zYDownUp}	mwcpkp
mwcpkpn --  mwpkp CODE-d	{#insert scpkmcpprompt}{#insert zYDownUp}{#insert dapt}	mwcpkpn
mwcpkpt --  mwpkp CODE-d	{#insert scpkmcpprompt}{#insert zYDownUp}{#insert dapn}	mwcpkpt
mwcpkpy --  mwpkp CODE-d	{#insert scpkmcpprompt}{#insert zYDownUp}{#insert dapn}	mwcpkpy
mwpkg -- func-name (siG start)	{#insert scpkmgprompt}{#insert zYDownUp}	mwpkg
mwpkgn -- func-name (siG start)	{#insert scpkmgprompt}{#insert zYDownUp}{#insert dapt}	mwpkgn
mwpkgt -- func-name (siG start)	{#insert scpkmgprompt}{#insert zYDownUp}{#insert dapn}	mwpkgt
mwpkgy -- func-name (siG start)	{#insert scpkmgprompt}{#insert zYDownUp}{#insert dapn}	mwpkgy
mwpkmrg -- Return type	{#insert scpkmrgprompt}{#insert zYDownUp}	mwpkrg
mwpkmrgn -- Return type	{#insert scpkmrgprompt}{#insert zYDownUp}{#insert dapt}	mwpkmrgn
mwpkmrgt -- Return type	{#insert scpkmrgprompt}{#insert zYDownUp}{#insert dapn}	mwpkmrgt
mwpkmrgy -- Return type	{#insert scpkmrgprompt}{#insert zYDownUp}{#insert dapn}	mwpkmrgy
mwpkp -- Params (open paren)	{#insert scpkmpprompt}{#insert zYDownUp}	mwpkp
mwpkpn -- Params (open paren)	{#insert scpkmpprompt}{#insert zYDownUp}{#insert dapt}	mwpkpn
mwpkpt -- Params (open paren)	{#insert scpkmpprompt}{#insert zYDownUp}{#insert dapn}	mwpkpt
mwpkpy -- Params (open paren)	{#insert scpkmpprompt}{#insert zYDownUp}{#insert dapn}	mwpkpy
