__XBN-PhraseExpress is released under the LGPL 2.1	(*XBN-PhraseExpress is a large set of generically-useful Microsoft Windows scripting tools, written in PhraseExpress, using the plain-text editor TextPad as its foundation.  //  Copyright (C) 2013 Jeff Epstein  //  This library is free software; you can redistribute it and/or modify it under the terms of the GNU Lesser General Public License as published by the Free Software Foundation; either version 2.1 of the License, or (at your option) any later version.  //  This library is distributed in the hope that it will be useful, but WITHOUT ANY WARRANTY; without even the implied warranty of MERCHANTABILITY or FITNESS FOR A PARTICULAR PURPOSE. See the GNU Lesser General Public License for more details.  //  You should have received a copy of the GNU Lesser General Public License along with this library; if not, write to the Free Software Foundation, Inc., 51 Franklin Street, Fifth Floor, Boston, MA 02110-1301 USA*)		(*Two tabs plus this comment, to force this phrase to be (a) imported, and (b) with NO autotext*)
ael	{#insert zzSetAngToNWycTo1}{#insert zzXPastePrvJFParamsAtCrsrDelRqstdFrom_M_wycAng}{#insert zzAnlsyn_M_yon}	ael
ael2	{#insert zzSetAngToNWycTo2}{#insert zzXPastePrvJFParamsAtCrsrDelRqstdFrom_M_wycAng}{#insert zzAnlsyn_M_yon}	ael2
ael3	{#insert zzSetAngToNWycTo3}{#insert zzXPastePrvJFParamsAtCrsrDelRqstdFrom_M_wycAng}{#insert zzAnlsyn_M_yon}	ael3
ael4	{#insert zzSetAngToNWycTo4}{#insert zzXPastePrvJFParamsAtCrsrDelRqstdFrom_M_wycAng}{#insert zzAnlsyn_M_yon}	ael4
ael5	{#insert zzSetAngToNWycTo5}{#insert zzXPastePrvJFParamsAtCrsrDelRqstdFrom_M_wycAng}{#insert zzAnlsyn_M_yon}	ael5
aelc	{#insert zzSetAngToNWycTo1}{#insert zzXCddPastePrvJFParamsAtCrsrDelRqstdFrom_M_wycAng}{#insert zzAnlsyn_M_yon}	aelc
aelc2	{#insert zzSetAngToNWycTo2}{#insert zzXCddPastePrvJFParamsAtCrsrDelRqstdFrom_M_wycAng}{#insert zzAnlsyn_M_yon}	aelc2
aelc3	{#insert zzSetAngToNWycTo3}{#insert zzXCddPastePrvJFParamsAtCrsrDelRqstdFrom_M_wycAng}{#insert zzAnlsyn_M_yon}	aelc3
aelc4	{#insert zzSetAngToNWycTo4}{#insert zzXCddPastePrvJFParamsAtCrsrDelRqstdFrom_M_wycAng}{#insert zzAnlsyn_M_yon}	aelc4
aelc5	{#insert zzSetAngToNWycTo5}{#insert zzXCddPastePrvJFParamsAtCrsrDelRqstdFrom_M_wycAng}{#insert zzAnlsyn_M_yon}	aelc5
aelcn	{#insert zzSetAngToNWycToPrompt}{#insert zzXCddPastePrvJFParamsAtCrsrDelRqstdFrom_M_wycAng}{#insert zzAnlsyn_M_yon}	aelcn
aelkpsyn	{#BALLOON -title ap[l,z]*: What to keep in params? -text [a,n,g,G,u,v] declares what should be kept in the params. [a]=all (types, generics, names), [n]=names only, [g]=type+generics, [G]=[g]+Html~escape, [u]=types for URL params, [v]=types for display~only abbreviations  //  Example: taplc2  //  aelsyn}	aelkpsyn
aeln	{#insert zzSetAngToNWycToPrompt}{#insert zzXPastePrvJFParamsAtCrsrDelRqstdFrom_M_wycAng}{#insert zzAnlsyn_M_yon}	aeln
aelsyn	{#BALLOON -title Syntax: Get~paste all params from sig -text {#insert zzAnlsyns1of3}  //  {#insert zzAnlsyns2of3}=Shortcut: nap[l,z]...  //  {#insert zzAnlsyns3of3}=escape all gnrcs (see kulsyn)  //  [a,n,g,G,u,v]: aelkpsyn // Example: napz2 // {#insert zzSglOptSynTxt}}	aelsyn
aeltestall	{#insert zzJavaTestIntroFileNew}{#insert zzzDupedSigLines}{#insert zTPGTDocTop}{#insert zzzSetAngAng2ToPrompt}aez{#insert zENTER}{#insert aez}{#insert zENTER}aez2{#insert zENTER}{#insert aez2}{#insert zENTER}aez3{#insert zENTER}{#insert aez3}{#insert zENTER}aezc{#insert zENTER}{#insert aezc}{#insert zENTER}aezc2{#insert zENTER}{#insert aezc2}{#insert zENTER}aezc3{#insert zENTER}{#insert aezc3}{#insert zENTER}aezcn{#insert zENTER}{#insert aezcn}{#insert zENTER}aezn{#insert zENTER}{#insert aezn}{#insert zzzEnterAng2}apz{#insert zzzEnterAng2}{#insert apz}{#insert zzzEnterAng2}apz2{#insert zzzEnterAng2}{#insert apz2}{#insert zzzEnterAng2}apz3{#insert zzzEnterAng2}{#insert apz3}{#insert zzzEnterAng2}apzc{#insert zzzEnterAng2}{#insert apzc}{#insert zzzEnterAng2}apzc2{#insert zzzEnterAng2}{#insert apzc2}{#insert zzzEnterAng2}apzc3{#insert zzzEnterAng2}{#insert apzc3}{#insert zzzEnterAng2}apzcn{#insert zzzEnterAng2}{#insert apzcn}{#insert zzzEnterAng2}apzn{#insert zzzEnterAng2}{#insert apzn}{#insert zTPGTDocBottom}{#insert zHOME}ael{#insert zENTER}{#insert ael}{#insert zENTER}ael2{#insert zENTER}{#insert ael2}{#insert zENTER}ael3{#insert zENTER}{#insert ael3}{#insert zENTER}aelc{#insert zENTER}{#insert aelc}{#insert zENTER}aelc2{#insert zENTER}{#insert aelc2}{#insert zENTER}aelc3{#insert zENTER}{#insert aelc3}{#insert zENTER}aelcn{#insert zENTER}{#insert aelcn}{#insert zENTER}aeln{#insert zENTER}{#insert aeln}{#insert zzzEnterAng2}apl{#insert zzzEnterAng2}{#insert apl}{#insert zzzEnterAng2}apl2{#insert zzzEnterAng2}{#insert apl2}{#insert zzzEnterAng2}apl3{#insert zzzEnterAng2}{#insert apl3}{#insert zzzEnterAng2}aplc{#insert zzzEnterAng2}{#insert aplc}{#insert zzzEnterAng2}aplc2{#insert zzzEnterAng2}{#insert aplc2}{#insert zzzEnterAng2}aplc3{#insert zzzEnterAng2}{#insert aplc3}{#insert zzzEnterAng2}aplcn{#insert zzzEnterAng2}{#insert aplcn}{#insert zzzEnterAng2}apln{#insert zzzEnterAng2}{#insert apln}{#insert zvSYNTAX_ON_stOn}{#insert zzAnlsyn_M_yon}	aeltestall
aez	{#insert zzSetAngToNWycTo1}{#insert zzXPasteNxtJFParamsAtCrsrDelRqstdFrom_M_wycAng}{#insert zzAnlsyn_M_yon}	aez
aez2	{#insert zzSetAngToNWycTo2}{#insert zzXPasteNxtJFParamsAtCrsrDelRqstdFrom_M_wycAng}{#insert zzAnlsyn_M_yon}	aez2
aez3	{#insert zzSetAngToNWycTo3}{#insert zzXPasteNxtJFParamsAtCrsrDelRqstdFrom_M_wycAng}{#insert zzAnlsyn_M_yon}	aez3
aez4	{#insert zzSetAngToNWycTo4}{#insert zzXPasteNxtJFParamsAtCrsrDelRqstdFrom_M_wycAng}{#insert zzAnlsyn_M_yon}	aez4
aez5	{#insert zzSetAngToNWycTo5}{#insert zzXPasteNxtJFParamsAtCrsrDelRqstdFrom_M_wycAng}{#insert zzAnlsyn_M_yon}	aez5
aezc	{#insert zzSetAngToNWycTo1}{#insert zzXCddPasteNxtJFParamsAtCrsrDelRqstdFrom_M_wycAng}{#insert zzAnlsyn_M_yon}	aezc
aezc2	{#insert zzSetAngToNWycTo2}{#insert zzXCddPasteNxtJFParamsAtCrsrDelRqstdFrom_M_wycAng}{#insert zzAnlsyn_M_yon}	aezc2
aezc3	{#insert zzSetAngToNWycTo3}{#insert zzXCddPasteNxtJFParamsAtCrsrDelRqstdFrom_M_wycAng}{#insert zzAnlsyn_M_yon}	aezc3
aezc4	{#insert zzSetAngToNWycTo4}{#insert zzXCddPasteNxtJFParamsAtCrsrDelRqstdFrom_M_wycAng}{#insert zzAnlsyn_M_yon}	aezc4
aezc5	{#insert zzSetAngToNWycTo5}{#insert zzXCddPasteNxtJFParamsAtCrsrDelRqstdFrom_M_wycAng}{#insert zzAnlsyn_M_yon}	aezc5
aezcn	{#insert zzSetAngToNWycToPrompt}{#insert zzXCddPasteNxtJFParamsAtCrsrDelRqstdFrom_M_wycAng}{#insert zzAnlsyn_M_yon}	aezcn
aezn	{#insert zzSetAngToNWycToPrompt}{#insert zzXPasteNxtJFParamsAtCrsrDelRqstdFrom_M_wycAng}{#insert zzAnlsyn_M_yon}	aezn
apl	{#insert zzSetAngToL1cWycTo1}{#insert zzXPastePrvJFParamsAtCrsrDelRqstdFrom_M_wycAng}{#insert zzAnlsyn_M_yon}	apl
apl2	{#insert zzSetAngToL1cWycTo2}{#insert zzXPastePrvJFParamsAtCrsrDelRqstdFrom_M_wycAng}{#insert zzAnlsyn_M_yon}	apl2
apl3	{#insert zzSetAngToL1cWycTo3}{#insert zzXPastePrvJFParamsAtCrsrDelRqstdFrom_M_wycAng}{#insert zzAnlsyn_M_yon}	apl3
apl4	{#insert zzSetAngToL1cWycTo4}{#insert zzXPastePrvJFParamsAtCrsrDelRqstdFrom_M_wycAng}{#insert zzAnlsyn_M_yon}	apl4
apl5	{#insert zzSetAngToL1cWycTo5}{#insert zzXPastePrvJFParamsAtCrsrDelRqstdFrom_M_wycAng}{#insert zzAnlsyn_M_yon}	apl5
aplc	{#insert zzSetAngToL1cWycTo1}{#insert zzXCddPastePrvJFParamsAtCrsrDelRqstdFrom_M_wycAng}{#insert zzAnlsyn_M_yon}	aplc
aplc2	{#insert zzSetAngToL1cWycTo2}{#insert zzXCddPastePrvJFParamsAtCrsrDelRqstdFrom_M_wycAng}{#insert zzAnlsyn_M_yon}	aplc2
aplc3	{#insert zzSetAngToL1cWycTo3}{#insert zzXCddPastePrvJFParamsAtCrsrDelRqstdFrom_M_wycAng}{#insert zzAnlsyn_M_yon}	aplc3
aplc3	{#insert zzSetAngToL1cWycTo3}{#insert zzXCddPastePrvJFParamsAtCrsrDelRqstdFrom_M_wycAng}{#insert zzAnlsyn_M_yon}	aplc3
aplc4	{#insert zzSetAngToL1cWycTo4}{#insert zzXCddPastePrvJFParamsAtCrsrDelRqstdFrom_M_wycAng}{#insert zzAnlsyn_M_yon}	aplc4
aplcn	{#insert zzSetAngToL1cWycToPrompt}{#insert zzXCddPastePrvJFParamsAtCrsrDelRqstdFrom_M_wycAng}{#insert zzAnlsyn_M_yon}	aplcn
apln	{#insert zzSetAngToL1cWycToPrompt}{#insert zzXPastePrvJFParamsAtCrsrDelRqstdFrom_M_wycAng}{#insert zzAnlsyn_M_yon}	apln
apz	{#insert zzSetAngToL1cWycTo1}{#insert zzXPasteNxtJFParamsAtCrsrDelRqstdFrom_M_wycAng}{#insert zzAnlsyn_M_yon}	apz
apz2	{#insert zzSetAngToL1cWycTo2}{#insert zzXPasteNxtJFParamsAtCrsrDelRqstdFrom_M_wycAng}{#insert zzAnlsyn_M_yon}	apz2
apz3	{#insert zzSetAngToL1cWycTo3}{#insert zzXPasteNxtJFParamsAtCrsrDelRqstdFrom_M_wycAng}{#insert zzAnlsyn_M_yon}	apz3
apz4	{#insert zzSetAngToL1cWycTo4}{#insert zzXPasteNxtJFParamsAtCrsrDelRqstdFrom_M_wycAng}{#insert zzAnlsyn_M_yon}	apz4
apz5	{#insert zzSetAngToL1cWycTo5}{#insert zzXPasteNxtJFParamsAtCrsrDelRqstdFrom_M_wycAng}{#insert zzAnlsyn_M_yon}	apz5
apzc	{#insert zzSetAngToL1cWycTo1}{#insert zzXCddPasteNxtJFParamsAtCrsrDelRqstdFrom_M_wycAng}{#insert zzAnlsyn_M_yon}	apzc
apzc2	{#insert zzSetAngToL1cWycTo2}{#insert zzXCddPasteNxtJFParamsAtCrsrDelRqstdFrom_M_wycAng}{#insert zzAnlsyn_M_yon}	apzc2
apzc3	{#insert zzSetAngToL1cWycTo3}{#insert zzXCddPasteNxtJFParamsAtCrsrDelRqstdFrom_M_wycAng}{#insert zzAnlsyn_M_yon}	apzc3
apzc4	{#insert zzSetAngToL1cWycTo4}{#insert zzXCddPasteNxtJFParamsAtCrsrDelRqstdFrom_M_wycAng}{#insert zzAnlsyn_M_yon}	apzc4
apzc5	{#insert zzSetAngToL1cWycTo5}{#insert zzXCddPasteNxtJFParamsAtCrsrDelRqstdFrom_M_wycAng}{#insert zzAnlsyn_M_yon}	apzc5
apzcn	{#insert zzSetAngToL1cWycToPrompt}{#insert zzXCddPasteNxtJFParamsAtCrsrDelRqstdFrom_M_wycAng}{#insert zzAnlsyn_M_yon}	apzcn
apzn	{#insert zzSetAngToL1cWycToPrompt}{#insert zzXPasteNxtJFParamsAtCrsrDelRqstdFrom_M_wycAng}{#insert zzAnlsyn_M_yon}	apzn
zXCddPrvNxtJFSigCopyParamsRtrnToX_M_gpnWyc -*-	{#insert zXmarkJCoded}{#insert zPrvNxtJFSigSelCopyParamsBackToX_M_gpnWyc}	zXCddPrvNxtJFSigCopyParamsRtrnToX_M_gpnWyc
zXPrvNxtJFSigCopyParamsRtrnToX_M_gpnWyc -*-	{#insert zXmark}{#insert zPrvNxtJFSigSelCopyParamsBackToX_M_gpnWyc}	zXPrvNxtJFSigCopyParamsRtrnToX_M_gpnWyc
zzAnlsyn_M_yon	{#insert {#COND -if {#insert zvSYNTAX_ON} = on -then aelsyn -else z1slp}}	zzAnlsyn_M_yon
zzAnlsyns1of3	[a,n,g,G,u,v]ap[l,z][c][2~5,n]	zzAnlsyns1of3
zzAnlsyns2of3	an[l,z][c][2~5,n]	zzAnlsyns2of3
zzAnlsyns3of3	papeg	zzAnlsyns3of3
zzXCddPasteNxtJFParamsAtCrsrDelRqstdFrom_M_wycAng	{#insert zvGPRV_NXT_stNext}{#insert zzXCddPastePrvNxtJFParamsAtCrsrDelRqstdFrm_M_gpnWycAng}	zzXCddPasteNxtJFParamsAtCrsrDelRqstdFrom_M_wycAng
zzXCddPastePrvJFParamsAtCrsrDelRqstdFrom_M_wycAng	{#insert zvGPRV_NXT_stPrev}{#insert zzXCddPastePrvNxtJFParamsAtCrsrDelRqstdFrm_M_gpnWycAng}	zzXCddPastePrvJFParamsAtCrsrDelRqstdFrom_M_wycAng
zzXCddPastePrvNxtJFParamsAtCrsrDelRqstdFrm_M_gpnWycAng -- See zSelCopyPrvNxtJFSigReturnToXCursor_M_gpnWyc	{#insert zXCddPrvNxtJFSigCopyParamsRtrnToX_M_gpnWyc}{#insert zTPPaste}{#insert zPostAllParamsKeepDelRqstd_M_ang}{#insert zzEscGnrcsIfAngNotLCGPreBrktGTP}	zzXCddPastePrvNxtJFParamsAtCrsrDelRqstdFrm_M_gpnWycAng
zzXPasteNxtJFParamsAtCrsrDelRqstdFrom_M_wycAng	{#insert zvGPRV_NXT_stNext}{#insert zzXPastePrvNxtJFParamsAtCrsrDelRqstdFrm_M_gpnWycAng}	zzXPasteNxtJFParamsAtCrsrDelRqstdFrom_M_wycAng
zzXPastePrvJFParamsAtCrsrDelRqstdFrom_M_wycAng	{#insert zvGPRV_NXT_stPrev}{#insert zzXPastePrvNxtJFParamsAtCrsrDelRqstdFrm_M_gpnWycAng}	zzXPastePrvJFParamsAtCrsrDelRqstdFrom_M_wycAng
zzXPastePrvNxtJFParamsAtCrsrDelRqstdFrm_M_gpnWycAng -- See zSelCopyPrvNxtJFSigReturnToXCursor_M_gpnWyc	{#insert zXPrvNxtJFSigCopyParamsRtrnToX_M_gpnWyc}{#insert zTPPaste}{#insert zPostAllParamsKeepDelRqstd_M_ang}	zzXPastePrvNxtJFParamsAtCrsrDelRqstdFrm_M_gpnWycAng
