zREGEXHtmlLinkSigAndDisp -- Group 1=url, 2=disp text	({#insert zjreFuncNameParams0orMore})[ \t]+([^ \t].+)	zREGEXHtmlLinkSigAndDisp
zjreArraySymbol1G	(\[])	zjreArraySymbol1G
zjreFunctionName	{#insert zzJreObjTypeFuncNamePrefix}	zjreFunctionName
zjreGenerics1G	(<[^>]+>)	zjreGenerics1G
zjreGenericsSimple -- At least one non-> between the brackets	(<[^>]+>){0,1}	zjreGenericsSimple
zjreGenericsStrict -- Only capital letters, and no spaces	(<([A-Z][A-Za-z0-9_]*){0,1}(,[A-Z][A-Za-z0-9_]*){0,}>){0,1}(*(<([A-Z]+){0,1}(,[A-Z]+){0,}>){0,1}*)	zjreGenericsStrict
zjreIdentifierChar	[A-Za-z][A-Za-z0-9_]	zjreIdentifierChar
zjreIdentifier	\<{#insert zjreIdentifierChar}+\>	zjreIdentifier
zjreTypeArray1SubG	\<{#insert zjreIdentifierChar}+{#insert zjreArraySymbol1G}	zjreTypeArray1SubG
zjreTypeGenerics1SubG	\<{#insert zjreIdentifierChar}+{#insert zjreGenerics1G}	zjreTypeGenerics1SubG
zjreObjectType	{#insert zzJreObjTypeFuncNamePrefix}(\[\]){0,1}	zjreObjectType
zjreOpenParenOrCmaSpc1G	([(]|, )	zjreOpenParenOrCmaSpc1G
zjreOpenParenParamTypeNameArray	{#insert zjreOpenParenOrCmaSpc1G}({#insert zjreTypeArray1SubG}) ({#insert zjreIdentifier})	zjreOpenParenParamTypeNameArray
zjreOpenParenParamTypeNameGenerics	{#insert zjreOpenParenOrCmaSpc1G}({#insert zjreTypeGenerics1SubG}) ({#insert zjreIdentifier})	zjreOpenParenParamTypeNameGenerics
zjreOpenParenParamTypeNamePlain	{#insert zjreOpenParenOrCmaSpc1G}({#insert zjreIdentifier}) ({#insert zjreIdentifier})	zjreOpenParenParamTypeNamePlain
zjreParamName	[A-Za-z][A-Za-z_0-9]*\>	zjreParamName
zjreParamType -- zjreTypeAndGenerics ALT KC	{#insert zjreTypeAndGenerics}	zjreParamType
zjreParamTypeThenName	{#insert zjreRetTypeFuncName} {#insert zjreParamName}	zjreParamTypeThenName
zjreRetTypeFuncName -- Regex for return-type-then-func-name (**)	(*Assumes that only spaces and tabs are between the return-type and function name, and that the open-paren immediately follows the function name--nothing between. Note that this will select the permission type instead of return type when used on a constructor. This does anticipate annotations between the JavaDoc block and function, such as @SuppressWarnings(QQuncheckedQQ).*){#insert zjreRetTypeWS}{#insert zjreFunctionName}	zjreRetTypeFuncName
zjreRetTypeWS	{#insert zjreTypeAndGenerics}[ \t]+	zjreRetTypeWS
zjreTypeAndGenerics	{#insert zjreObjectType}{#insert zjreGenericsStrict}	zjreTypeAndGenerics
zzJreObjTypeFuncNamePrefix	\<{#insert zjreIdentifierChar}*\>	zzJreObjTypeFuncNamePrefix
zjreOpenParenOrCmaSpcParamTypePlainArrayGenerics -- 5 groups (**)	(*g1=Open paren or comma-spc, g2=type-incl-gen-or-array-symbol, g3=Open paren or comma-space, g4=generics or array symbol, g5=param name*){#insert zjreOpenParenOrCmaSpc1G}(\<{#insert zjreIdentifierChar}+\>(<[^>]+>|\[]){0,1}) ({#insert zjreIdentifier})(*ends with space*)	zjreOpenParenOrCmaSpcParamTypePlainArrayGenerics
