zHtmlEscJGnrcsB4CrsrGTPEndCode -*-	{#insert zHtmlEscJavaGnrcsB4Cursor}{#insert zPreBracketGTP}	zHtmlEscJGnrcsB4CrsrGTPEndCode
zHtmlEscJavaGnrcsB4Cursor -*- '>' is immediately before the cursor	{#insert zPostBracketSelect}{#insert zHtmlEscSlctdJavaGenerics}{#insert zRIGHT}	zHtmlEscJavaGnrcsB4Cursor
zJFRtrnTypeFNmSlctd_selectReturnTypeNoGnrcs -*- 	{#insert zLEFT}{#insert zTPSelectR1w}	zJFRtrnTypeFNmSlctd_selectReturnTypeNoGnrcs
zJFRtrnTypeFNmSlctd_selectReturnTypeWGnrcs -*- Assumes spcs&tbs-only b/t ret-type-gnrcs & func-name	{#insert zSelectL2w}{#insert zTPSelectR1w}	zJFRtrnTypeFNmSlctd_selectReturnTypeWGnrcs
zXPrvNxtJFSigCopyReturnTypeNoGnrcsPasteAtX_M_cdeGpnWyc	{#insert zXPrvNxtJFSigCopyReturnTypeNoGnrcsRtrnToX_M_cdeGpnWyc}{#insert zTPPaste}	zXPrvNxtJFSigCopyReturnTypeNoGnrcsPasteAtX_M_cdeGpnWyc
zXPrvNxtJFSigCopyReturnTypeNoGnrcsRtrnToX_M_cdeGpnWyc -*-(*!*)- Needs zvCODED_ES, zvGPRV_NXT	(*See zSelCopyPrvNxtJFSigReturnToXCursor_M_gpnWyc*){#insert zXSelectRtrnTypeFNmInNxtPrvJFSig_M_cdeGpnWyc}{#insert zJFRtrnTypeFNmSlctd_selectReturnTypeNoGnrcs}{#insert zTPCopy}{#insert zzXUpDownOppositeDir_M_gpn}	zXPrvNxtJFSigCopyReturnTypeNoGnrcsRtrnToX_M_cdeGpnWyc
zXPrvNxtJFSigCopyReturnTypeWGnrcsPasteAtX_M_cdeGpnWyc	{#insert zXPrvNxtJFSigCopyReturnTypeWGnrcsRtrnToX_M_cdeGpnWyc}{#insert zTPPaste}	zXPrvNxtJFSigCopyReturnTypeWGnrcsPasteAtX_M_cdeGpnWyc
zXPrvNxtJFSigCopyReturnTypeWGnrcsRtrnToX_M_cdeGpnWyc -*-(*!*)- Needs zvCODED_ES, zvGPRV_NXT	(*See zSelCopyPrvNxtJFSigReturnToXCursor_M_gpnWyc*){#insert zXSelectRtrnTypeFNmInNxtPrvJFSig_M_cdeGpnWyc}{#insert zJFRtrnTypeFNmSlctd_selectReturnTypeWGnrcs}{#insert zTPCopy}{#insert zzXUpDownOppositeDir_M_gpn}	zXPrvNxtJFSigCopyReturnTypeWGnrcsRtrnToX_M_cdeGpnWyc
zXSelectRtrnTypeFNmInNxtPrvJFSig_M_cdeGpnWyc -*-	{#insert zzXmarkMaybeCdd_M_cde}{#insert zGoToOpenParenInPrvNxtJavaSig_M_gpnWyc}{#insert zTMFindPrevParamTypeAndName}{#insert zTPSelSwapEnds}	zXSelectRtrnTypeFNmInNxtPrvJFSig_M_cdeGpnWyc
zvES_23N_stPrompt	{#SETPHRASE -description zvES_23_PROMPT -content {#REPLACE {#INPUT -head Which sig? ('1', '2', '3', or 'n' for prompt) -def 1 -single} -oldtext p -newtext Prompt} -autotext zvES_23N -folder ctvv_folder}	zvES_23N_stPrompt
zzSetCddToESGpnToNextWncTo1	{#insert zvCODED_ES_stES}{#insert zzSetGpnToNextWncTo1}	zzSetCddToESGpnToNextWncTo1
zzSetCddToESGpnToNextWncTo2	{#insert zvCODED_ES_stES}{#insert zzSetGpnToNextWncTo2}	zzSetCddToESGpnToNextWncTo2
zzSetCddToESGpnToNextWncTo3	{#insert zvCODED_ES_stES}{#insert zzSetGpnToNextWncTo3}	zzSetCddToESGpnToNextWncTo3
zzSetCddToESGpnToNextWncToPrompt	{#insert zvCODED_ES_stES}{#insert zzSetGpnToNextWncToPrompt}	zzSetCddToESGpnToNextWncToPrompt
zzSetCddToESGpnToPrevWncTo1	{#insert zvCODED_ES_stES}{#insert zzSetGpnToPrevWncTo1}	zzSetCddToESGpnToPrevWncTo1
zzSetCddToESGpnToPrevWncTo2	{#insert zvCODED_ES_stES}{#insert zzSetGpnToPrevWncTo2}	zzSetCddToESGpnToPrevWncTo2
zzSetCddToESGpnToPrevWncTo3	{#insert zvCODED_ES_stES}{#insert zzSetGpnToPrevWncTo3}	zzSetCddToESGpnToPrevWncTo3
zzSetCddToESGpnToPrevWncToPrompt	{#insert zvCODED_ES_stES}{#insert zzSetGpnToPrevWncToPrompt}	zzSetCddToESGpnToPrevWncToPrompt
zzSetGpnToNextWncTo1	{#insert zvGPRV_NXT_stNext}{#insert zvAWAY_CNT_st1}	zzSetGpnToNextWncTo1
zzSetGpnToNextWncTo2	{#insert zvGPRV_NXT_stNext}{#insert zvAWAY_CNT_st2}	zzSetGpnToNextWncTo2
zzSetGpnToNextWncTo3	{#insert zvGPRV_NXT_stNext}{#insert zvAWAY_CNT_st3}	zzSetGpnToNextWncTo3
zzSetGpnToNextWncToPrompt	{#insert zvGPRV_NXT_stNext}{#insert zvAWAY_CNT_stPrompt}	zzSetGpnToNextWncToPrompt
zzSetGpnToPrevWncTo1	{#insert zvGPRV_NXT_stPrev}{#insert zvAWAY_CNT_st1}	zzSetGpnToPrevWncTo1
zzSetGpnToPrevWncTo2	{#insert zvGPRV_NXT_stPrev}{#insert zvAWAY_CNT_st2}	zzSetGpnToPrevWncTo2
zzSetGpnToPrevWncTo3	{#insert zvGPRV_NXT_stPrev}{#insert zvAWAY_CNT_st3}	zzSetGpnToPrevWncTo3
zzSetGpnToPrevWncToPrompt	{#insert zvGPRV_NXT_stPrev}{#insert zvAWAY_CNT_stPrompt}	zzSetGpnToPrevWncToPrompt
