__XBN-PhraseExpress is released under the LGPL 2.1	(*XBN-PhraseExpress is a large set of generically-useful Microsoft Windows scripting tools, written in PhraseExpress, using the plain-text editor TextPad as its foundation.  //  Copyright (C) 2013 Jeff Epstein  //  This library is free software; you can redistribute it and/or modify it under the terms of the GNU Lesser General Public License as published by the Free Software Foundation; either version 2.1 of the License, or (at your option) any later version.  //  This library is distributed in the hope that it will be useful, but WITHOUT ANY WARRANTY; without even the implied warranty of MERCHANTABILITY or FITNESS FOR A PARTICULAR PURPOSE. See the GNU Lesser General Public License for more details.  //  You should have received a copy of the GNU Lesser General Public License along with this library; if not, write to the Free Software Foundation, Inc., 51 Franklin Street, Fifth Floor, Boston, MA 02110-1301 USA*)		(*Two tabs plus this comment, to force this phrase to be (a) imported, and (b) with NO autotext*)
zPromptSetPrivateKey_M_pjDtv	{#insert zvCVT_FRMV_1C_stPrvk_M_pjDtv}{#SETPHRASE -description {#insert zIntrnlVarNm_M_pjDtFrm1} -content {#insert zzPrvKey1CFromLCPromptForNewIns1C_M_pjDtFrm1} -autotext {#insert zIntrnlVarNm_M_pjDtFrm1} -folder ctvv_folder}	zPromptSetPrivateKey_M_pjDtv
zPromptSetPubAndPrivKeys_M_pjDtv	{#insert zPromptSetPublicKeyInclLC_M_pjDtv}{#insert zPromptSetPrivateKey_M_pjDtv}	zPromptSetPubAndPrivKeys_M_pjDtv
zPromptSetPubSetPrivKey_M_pjDtv	{#insert zPromptSetPublicKeyInclLC_M_pjDtv}{#insert zSetPrivateKeyCIES_M_pjDtvPubk}	zPromptSetPubSetPrivKey_M_pjDtv
zPromptSetPublicKeyInclLC_M_pjDtv	{#insert zvCVT_FRMV_1C_stPubk_M_pjDtv}{#SETPHRASE -description {#insert zIntrnlVarNm_M_pjDtFrm1} -content {#insert zzPubKey1CFromLCPrompt_M_pjDtFrm1} -autotext {#insert zIntrnlVarNm_M_pjDtFrm1} -folder ctvv_folder}{#insert zSetPubkLC_M_pjDtPubkfrm1Pubk}	zPromptSetPublicKeyInclLC_M_pjDtv
zSetCBPubPWPrivKeys_M_pjDtv	{#insert zSetPubKeyInclLCToCB_M_pjDtv}{#insert zCutL1w}{#insert zSetPrivKeyToCB_M_pjDtv}	zSetCBPubPWPrivKeys_M_pjDtv
zSetPrivKeyToCB_M_pjDtv	{#insert zvCVT_FRMV_1C_stPrvk_M_pjDtv}{#insert zSetIntrnlVarToCB_M_pjDtFrm1}	zSetPrivKeyToCB_M_pjDtv
zSetPrivPubKeysFromPrev2Words_M_pjDtv -- Assumes 1 space between	{#insert zCutL1w}{#insert zBKSP}{#insert zSetCBPubPWPrivKeys_M_pjDtv}	zSetPrivPubKeysFromPrev2Words_M_pjDtv
zSetPrivateKeyCIES_M_pjDtvPubk -- Crashes if it's empty-string	{#BALLOON -title Please wait... -text Obtaining private{#insert zAscDash}key for given public{#insert zAscDash}key}{#insert zvCVT_FRMV_1C_stPrvk_M_pjDtv}{#SETPHRASE -description zvPRVK_INTRNL_VNM -content {#insert zIntrnlVarNm_M_pjDtFrm1} -autotext zvPRVK_INTRNL_VNM -folder ctvv_folder}{#SETPHRASE -description {#insert zvPRVK_INTRNL_VNM} -content {#insert zzPrivKValueFromPubKValueOnly_M_pjDtFrm1} -autotext {#insert zvPRVK_INTRNL_VNM} -folder ctvv_folder}{#insert {#COND -if {#LENGTH {#insert {#insert zvPRVK_INTRNL_VNM}}} = 0 -then zzErrDlgUnknownPubKey_M_pjDtvPubkfrm1 -else z1slp}}	zSetPrivateKeyCIES_M_pjDtvPubk
zSetPubKeyInclLCToCB_M_pjDtv	{#insert zvCVT_FRMV_1C_stPubk_M_pjDtv}{#insert zSetIntrnlVarToCB_M_pjDtFrm1}{#insert zSetPubkLC_M_pjDtPubkfrm1Pubk}	zSetPubKeyInclLCToCB_M_pjDtv
zSetPubkLC_M_pjDtv	{#insert zvCVT_FRMV_1C_stPubk_M_pjDtv}{#insert zSetPubkLC_M_pjDtPubkfrm1Pubk}	zSetPubkLC_M_pjDtv
zSetPubkLC_M_pjDtPubkfrm1Pubk	{#SETPHRASE -description {#insert zIntrnlVarNm_M_pjDtFrm1}_LC -content {#LOWERCASE {#insert zIntrnlVarValue_M_pjDtFrm1}} -autotext {#insert zIntrnlVarNm_M_pjDtFrm1}_LC -folder ctvv_folder}(*{#MSGBOX -head zSetPubkLC_M_pjDtPubkfrm1Pubk (post-debugging) -text zIntrnlVarNm_M_pjDtFrm1='{#insert zIntrnlVarNm_M_pjDtFrm1}'='{#insert zIntrnlVarValue_M_pjDtFrm1}', zvPRJ_ABRV_1C='{#insert zvPRJ_ABRV_1C}', zvDTYPE_ABRV_1C='{#insert zvDTYPE_ABRV_1C}', zvCVT_FRMV_1C='{#insert zvCVT_FRMV_1C}', {#insert zIntrnlVarNm_M_pjDtFrm1}_LC='{#insert {#insert zIntrnlVarNm_M_pjDtFrm1}_LC}'}*)	zSetPubkLC_M_pjDtPubkfrm1Pubk
zvCVT_FRMV_1C_stPrvk_M_pjDtv	{#SETPHRASE -description zvCVT_FRMV_1C -content {#insert zPrivKeyCVTFromAbrv1C_M_pjDtv} -autotext zvCVT_FRMV_1C -folder ctvv_folder}	zvCVT_FRMV_1C_stPrvk_M_pjDtv
zvCVT_FRMV_1C_stPubk_M_pjDtv	{#SETPHRASE -description zvCVT_FRMV_1C -content {#insert zPubKeyCVTFromAbrv1C_M_pjDtv} -autotext zvCVT_FRMV_1C -folder ctvv_folder}	zvCVT_FRMV_1C_stPubk_M_pjDtv
zzErrDlgUnknownPubKey_M_pjDtvPubkfrm1 -(*!!*)-	{#BALLOON -title Please wait... -text Unknown public key. Gathering error/debugging information}(*Assumes zvCVT_FRMV_1C is the pub-key's pre-from-abrv, and that a public-key was indeed provided (a non-empty-string is in the variable)*){#insert zvCVT_FRMV_1C_stPubk_M_pjDtv}{#MSGBOX -head ERROR: Unknown public-key -text ERROR. The PUBLIC-key value you provided, '{#insert zIntrnlVarValue_M_pjDtFrm1}' is unknown. There is no corresponding PRIVATE-key configuration-variable, with the name '{#insert zzPrivKPNmFromPubKValueOnly_M_pjDtvPrvkfrm1}'--either it doesn't exist, or it contains an empty-string phrase-body. Both situations are illegal. Detailed information about the public-key cv-type -- {#insert zvCVT_FRMV_1C_stPubk_M_pjDtv}{#insert zzLpdDebugCVTypeDlgTxt_M_pjDtFrm1}  ///  {#insert zCancelProcNowPostTxt}}	zzErrDlgUnknownPubKey_M_pjDtvPubkfrm1
zzPrvKey1CFromLCPromptForNewIns1C_M_pjDtFrm1 -- Prompts for LC, converts to 1C	{#UPPERCASEFIRST {#INPUT -head Lowercase '{#insert zCfgVarPhrsNmPost_M_pjDtFrm1}' for new instance? (prvk) -single}}	zzPrvKey1CFromLCPromptForNewIns1C_M_pjDtFrm1
zzPubKey1CFromLCPrompt_M_pjDtFrm1 -- Prompts for LC, converts to 1C	{#UPPERCASEFIRST {#INPUT -head Lowercase '{#insert zCfgVarPhrsNmPost_M_pjDtFrm1}'? (pubk) -single}}	zzPubKey1CFromLCPrompt_M_pjDtFrm1
zzPrivKPNmFromPubKValueOnly_M_pjDtvPrvkfrm1 -- Frm1 IS set to prvk	{#insert zzLpdpsPNmPre2Zs_M_pjDtv}{#insert zvCVT_FRMV_1C_stPubk_M_pjDtv}{#insert zIntrnlVarValue_M_pjDtFrm1}{#insert zvCVT_FRMV_1C_stPrvk_M_pjDtv}{#insert zCfgVarPhrsNmPost_M_pjDtFrm1}	zzPrivKPNmFromPubKValueOnly_M_pjDtvPrvkfrm1
zzPrivKPNmFromPubKValueOnly_M_pjDtFrm1_README	(*Regarding '{#insert zIntrnlVarValue_M_pjDtFrm1}': {#insert zCfgValue_M_pjDtFrm1Key}<--NO! The NAME of the public key requires the VALUE of the private key, and that's exactly what we DON'T have yet--that's the goal of this phrase, to get the value of the private key. Circular dependency. What we DO have is the VALUE of the public key, as set into it's internal variable.  //  YES-->{#insert {#insert zIntrnlVarNm_M_pjDtFrm1}}*)	zzPrivKPNmFromPubKValueOnly_M_pjDtFrm1_README
zzPrivKValueFromPubKValueOnly_M_pjDtFrm1 [4dlg]	{#insert {#insert zzPrivKPNmFromPubKValueOnly_M_pjDtvPrvkfrm1}}	zzPrivKValueFromPubKValueOnly_M_pjDtFrm1
