
mbkc -- {#MSGBOX -head -text -ok -cancel}	{#insert zvESC_LVL_CNT_st0}{#insert zMbkcRAW_M_elc}{#insert zzMbxSyn}	mbkc
mbkch -- {#MSGBOX -head [crsr] -text -ok -cancel}	{#insert zvESC_LVL_CNT_st0}{#insert zMbkchRAW_M_elc}{#insert zzMbxSyn}	mbkch
mbkchp -- mbkch, escaped	{#insert zvESC_LVL_CNT_st1}{#insert zMbkchRAW_M_elc}{#insert zzMbxSyn}	mbkchp
mbkchq -- mbkch, doubly-escaped (or more)	{#insert zvESC_LVL_CNT_stPrompt}{#insert zMbkchRAW_M_elc}{#insert zzMbxSyn}	mbkchq
mbkcp -- mbkc, escaped	{#insert zvESC_LVL_CNT_st1}{#insert zMbkcRAW_M_elc}{#insert zzMbxSyn}	mbkcp
mbkcq -- mbkc, doubly-escaped (or more)	{#insert zvESC_LVL_CNT_stPrompt}{#insert zMbkcRAW_M_elc}{#insert zzMbxSyn}	mbkcq
mbkct -- {#MSGBOX -head -text [crsr] -ok -cancel}	{#insert zvESC_LVL_CNT_st0}{#insert zMbkctRAW_M_elc}{#insert zzMbxSyn}	mbkct
mbkctp -- mbkct, escaped	{#insert zvESC_LVL_CNT_st1}{#insert zMbkctRAW_M_elc}{#insert zzMbxSyn}	mbkctp
mbkctq -- mbkct, doubly-escaped (or more)	{#insert zvESC_LVL_CNT_stPrompt}{#insert zMbkctRAW_M_elc}{#insert zzMbxSyn}	mbkctq
mbr -- {#MSGBOX -head ERROR -text ERROR ~~ [crsr]}	{#insert zvESC_LVL_CNT_st0}{#insert zMbrRAW_M_elc}{#insert zzMbxSyn}	mbr
mbrp -- mbr, escaped	{#insert zvESC_LVL_CNT_st1}{#insert zMbrRAW_M_elc}{#insert zzMbxSyn}	mbrp
mbrq -- mbr, doubly-escaped (or more)	{#insert zvESC_LVL_CNT_stPrompt}{#insert zMbrRAW_M_elc}{#insert zzMbxSyn}	mbrq
mbx -- {#MSGBOX -head ... -text ...}	{#insert zvESC_LVL_CNT_st0}{#insert zMbxRAW_M_elc}{#insert zzMbxSyn}	mbx
mbxh -- {#MSGBOX -head [crsr] -text ...}	{#insert zvESC_LVL_CNT_st0}{#insert zMbxhRAW_M_elc}{#insert zzMbxSyn}	mbxh
mbxhp -- mbxh, escaped	{#insert zvESC_LVL_CNT_st1}{#insert zMbxhRAW_M_elc}{#insert zzMbxSyn}	mbxhp
mbxhq -- mbxh, doubly-escaped (or more)	{#insert zvESC_LVL_CNT_stPrompt}{#insert zMbxhRAW_M_elc}{#insert zzMbxSyn}	mbxhq
mbxp -- mbx, escaped	{#insert zvESC_LVL_CNT_st1}{#insert zMbxRAW_M_elc}{#insert zzMbxSyn}	mbxp
mbxq -- mbx, doubly-escaped (or more)	{#insert zvESC_LVL_CNT_stPrompt}{#insert zMbxRAW_M_elc}{#insert zzMbxSyn}	mbxq
mbxt -- {#MSGBOX -head ... -text [crsr]}	{#insert zvESC_LVL_CNT_st0}{#insert zMbxtRAW_M_elc}{#insert zzMbxSyn}	mbxt
mbxtp -- mbxt, escaped	{#insert zvESC_LVL_CNT_st1}{#insert zMbxtRAW_M_elc}{#insert zzMbxSyn}	mbxtp
mbxtq -- mbxt, doubly-escaped (or more)	{#insert zvESC_LVL_CNT_stPrompt}{#insert zMbxtRAW_M_elc}{#insert zzMbxSyn}	mbxtq
mbyn -- {#MSGBOX -head -text -yes -no}	{#insert zvESC_LVL_CNT_st0}{#insert zMbynRAW_M_elc}{#insert zzMbxSyn}	mbyn
mbync -- {#MSGBOX -head -text -yes -no -cancel}	{#insert zvESC_LVL_CNT_st0}{#insert zMbyncRAW_M_elc}{#insert zzMbxSyn}	mbync
mbynch -- {#MSGBOX -head [crsr] -text -yes -no -cancel}	{#insert zvESC_LVL_CNT_st0}{#insert zMbynchRAW_M_elc}{#insert zzMbxSyn}	mbynch
mbynchp -- mbynch, escaped	{#insert zvESC_LVL_CNT_st1}{#insert zMbynchRAW_M_elc}{#insert zzMbxSyn}	mbynchp
mbynchq -- mbynch, doubly-escaped (or more)	{#insert zvESC_LVL_CNT_stPrompt}{#insert zMbynchRAW_M_elc}{#insert zzMbxSyn}	mbynchq
mbyncp -- mbync, escaped	{#insert zvESC_LVL_CNT_st1}{#insert zMbyncRAW_M_elc}{#insert zzMbxSyn}	mbyncp
mbyncq -- mbync, doubly-escaped (or more)	{#insert zvESC_LVL_CNT_stPrompt}{#insert zMbyncRAW_M_elc}{#insert zzMbxSyn}	mbyncq
mbynct -- {#MSGBOX -head -text [crsr] -yes -no -cancel}	{#insert zvESC_LVL_CNT_st0}{#insert zMbynctRAW_M_elc}{#insert zzMbxSyn}	mbynct
mbynctp -- mbynct, escaped	{#insert zvESC_LVL_CNT_st1}{#insert zMbynctRAW_M_elc}{#insert zzMbxSyn}	mbynctp
mbynctq -- mbynct, doubly-escaped (or more)	{#insert zvESC_LVL_CNT_stPrompt}{#insert zMbynctRAW_M_elc}{#insert zzMbxSyn}	mbynctq
mbynh -- {#MSGBOX -head [crsr] -text -yes -no}	{#insert zvESC_LVL_CNT_st0}{#insert zMbynhRAW_M_elc}{#insert zzMbxSyn}	mbynh
mbynhp -- mbynh, escaped	{#insert zvESC_LVL_CNT_st1}{#insert zMbynhRAW_M_elc}{#insert zzMbxSyn}	mbynhp
mbynhq -- mbynh, doubly-escaped (or more)	{#insert zvESC_LVL_CNT_stPrompt}{#insert zMbynhRAW_M_elc}{#insert zzMbxSyn}	mbynhq
mbynp -- mbyn, escaped	{#insert zvESC_LVL_CNT_st1}{#insert zMbynRAW_M_elc}{#insert zzMbxSyn}	mbynp
mbynq -- mbyn, doubly-escaped (or more)	{#insert zvESC_LVL_CNT_stPrompt}{#insert zMbynRAW_M_elc}{#insert zzMbxSyn}	mbynq
mbynt -- {#MSGBOX -head -text [crsr] -yes -no}	{#insert zvESC_LVL_CNT_st0}{#insert zMbyntRAW_M_elc}{#insert zzMbxSyn}	mbynt
mbyntp -- mbynt, escaped	{#insert zvESC_LVL_CNT_st1}{#insert zMbyntRAW_M_elc}{#insert zzMbxSyn}	mbyntp
mbyntq -- mbynt, doubly-escaped (or more)	{#insert zvESC_LVL_CNT_stPrompt}{#insert zMbyntRAW_M_elc}{#insert zzMbxSyn}	mbyntq
pccmbxtestall	{#SETPHRASE -description zvQB_STR_LIST -content {#insert zzPccMbxAllMainAbrvs1CQBL} -autotext zvQB_STR_LIST -folder ctvv_folder}{#insert zzTestAllMainPhrsCrtrAbrvs_M_qbl}	pccmbxtestall
zMbkcRAW_M_elc -- Needs zvESC_LVL_CNT (assumed good value!)	{#insert zOY_M_elc}#MSGBOX -head {#insert zXmark} -text {#insert zXmark} -ok {#insert zYmark} -cancel {#insert zYmark}{#insert zCY_M_elc}	zMbkcRAW_M_elc
zMbkchRAW_M_elc	{#insert zOY_M_elc}#MSGBOX -head  -text {#insert zXmark} -ok {#insert zYmark} -cancel {#insert zYmark}{#insert zCY_M_elc}{#insert zzLeftPrevEscCrly_M_elc}{#LEFT -count 30}	zMbkchRAW_M_elc
zMbkctRAW_M_elc	{#insert zOY_M_elc}#MSGBOX -head {#insert zXmark} -text  -ok {#insert zYmark} -cancel {#insert zYmark}{#insert zCY_M_elc}{#insert zzLeftPrevEscCrly_M_elc}{#LEFT -count 20}	zMbkctRAW_M_elc
zMbrRAW_M_elc	{#insert zOY_M_elc}#MSGBOX -head ERROR -text ERROR ~~ \\\{#insert zCancelProcNowPostTxt\\\}{#insert zCY_M_elc}{#insert zzLeftPrevEscCrly_M_elc}{#LOOP {#LEFT} -count {#LENGTH \\\{#insert zCancelProcNowPostTxt\\\}}}	zMbrRAW_M_elc
zMbxRAW_M_elc	{#insert zOY_M_elc}#MSGBOX -head {#insert zXmark} -text {#insert zXmark}{#insert zCY_M_elc}	zMbxRAW_M_elc
zMbxhRAW_M_elc	{#insert zOY_M_elc}#MSGBOX -head  -text {#insert zXmark}{#insert zCY_M_elc}{#insert zzLeftPrevEscCrly_M_elc}{#LEFT -count 10}	zMbxhRAW_M_elc
zMbxtRAW_M_elc	{#insert zOY_M_elc}#MSGBOX -head {#insert zXmark} -text {#insert zCY_M_elc}{#insert zzLeftPrevEscCrly_M_elc}	zMbxtRAW_M_elc
zMbynRAW_M_elc	{#insert zOY_M_elc}#MSGBOX -head {#insert zXmark} -text {#insert zXmark} -yes {#insert zYmark} -no {#insert zYmark}{#insert zCY_M_elc}	zMbynRAW_M_elc
zMbyncRAW_M_elc	{#insert zOY_M_elc}#MSGBOX -head {#insert zXmark} -text {#insert zXmark} -yes {#insert zYmark} -no {#insert zYmark} -cancel {#insert zYmark}{#insert zCY_M_elc}	zMbyncRAW_M_elc
zMbynchRAW_M_elc	{#insert zOY_M_elc}#MSGBOX -head  -text {#insert zXmark} -yes {#insert zYmark} -no {#insert zYmark} -cancel {#insert zYmark}{#insert zCY_M_elc}{#insert zzLeftPrevEscCrly_M_elc}{#LEFT -count 39}	zMbynchRAW_M_elc
zMbynctRAW_M_elc	{#insert zOY_M_elc}#MSGBOX -head {#insert zXmark} -text  -yes {#insert zYmark} -no {#insert zYmark} -cancel {#insert zYmark}{#insert zCY_M_elc}{#insert zzLeftPrevEscCrly_M_elc}{#LEFT -count 29}	zMbynctRAW_M_elc
zMbynhRAW_M_elc	{#insert zOY_M_elc}#MSGBOX -head  -text {#insert zXmark} -yes {#insert zYmark} -no {#insert zYmark}{#insert zCY_M_elc}{#insert zzLeftPrevEscCrly_M_elc}{#LEFT -count 27}	zMbynhRAW_M_elc
zMbyntRAW_M_elc	{#insert zOY_M_elc}#MSGBOX -head {#insert zXmark} -text  -yes {#insert zYmark} -no {#insert zYmark}{#insert zCY_M_elc}{#insert zzLeftPrevEscCrly_M_elc}{#LEFT -count 17}	zMbyntRAW_M_elc
zzMbxSyn	{#BALLOON -title MSGBOX (mbx) syntax -text mb[[kc,yn[c],x]][[h,t]][[p,q]], mbr  //  Targets must be phrase NAMES, NOT calls (meaning not surrounded by \\\{#insert ...\\\})  //  [p]=esc'd, [q]=dbly~esc'd (or more)  //  'z[1c~abrv~w/o~pq]RAW_M_elc' (ex: 'zMbynRAW_M_elc')  //  lcmtargetinfo  //  pccmbxtestall}	zzMbxSyn
zzPccMbxAllMainAbrvs1CQBL	[Mbkc][Mbkch][Mbkct][Mbr][Mbx][Mbxh][Mbxt][Mbyn][Mbync][Mbynch][Mbynct][Mbynh][Mbynt]	zzPccMbxAllMainAbrvs1CQBL
