pccstptestall	{#SETPHRASE -description zvQB_STR_LIST -content {#insert zzPccStpAllMainAbrvs1CQBL} -autotext zvQB_STR_LIST -folder ctvv_folder}{#insert zzTestAllMainPhrsCrtrAbrvs_M_qbl}	pccstptestall
stm -- {#SETPHRASE -dsc [prompt] -cntnt ... -atx [prompt]...}	{#insert zvESC_LVL_CNT_st0}{#insert zStmRAW_M_elc}{#insert zzStpSyn}	stm
stmc -- {#SETPHRASE -dsc [prompt] -cntnt ... -atx [prompt]...}	{#insert zvESC_LVL_CNT_st0}{#insert zStmcRAW_M_elc}{#insert zzStpSyn}	stmc
stmcb -- {#SETPHRASE -dsc [prompt] -cntnt [paste] -atx [prompt]...}	{#insert zvESC_LVL_CNT_st0}{#insert zStmcbRAW_M_elc}{#insert zzStpSyn}	stmcb
stmcbp -- stmcb, escaped	{#insert zvESC_LVL_CNT_st1}{#insert zStmcbRAW_M_elc}{#insert zzStpSyn}	stmcbp
stmcbq -- stmcb, doubly-escaped (or more)	{#insert zvESC_LVL_CNT_stPrompt}{#insert zStmcbRAW_M_elc}{#insert zzStpSyn}	stmcbq
stmccb -- {#SETPHRASE -dsc [prompt] -cntnt {#insert [paste]} -atx [prompt]...}	{#insert zvESC_LVL_CNT_st0}{#insert zStmccbRAW_M_elc}{#insert zzStpSyn}	stmccb
stmccbp -- stmccb, escaped	{#insert zvESC_LVL_CNT_st1}{#insert zStmccbRAW_M_elc}{#insert zzStpSyn}	stmccbp
stmccbq -- stmccb, doubly-escaped (or more)	{#insert zvESC_LVL_CNT_stPrompt}{#insert zStmccbRAW_M_elc}{#insert zzStpSyn}	stmccbq
stmce -- stmc, no content (empty-string)	{#insert zvESC_LVL_CNT_st0}{#insert zStmceRAW_M_elc}{#insert zzStpSyn}	stmce
stmcep -- stmce, escaped	{#insert zvESC_LVL_CNT_st1}{#insert zStmceRAW_M_elc}{#insert zzStpSyn}	stmcep
stmceq -- stmce, doubly-escaped (or more)	{#insert zvESC_LVL_CNT_stPrompt}{#insert zStmceRAW_M_elc}{#insert zzStpSyn}	stmceq
stmcp -- stmc, escaped	{#insert zvESC_LVL_CNT_st1}{#insert zStmcRAW_M_elc}{#insert zzStpSyn}	stmcp
stmcq -- stmc, doubly-escaped (or more)	{#insert zvESC_LVL_CNT_stPrompt}{#insert zStmcRAW_M_elc}{#insert zzStpSyn}	stmcq
stmct -- {#SETPHRASE -dsc [prompt] -cntnt {#insert [paste]} -atx [prompt]...}	{#insert zvESC_LVL_CNT_st0}{#insert zStmctRAW_M_elc}{#insert zzStpSyn}	stmct
stmctp -- stmct, escaped	{#insert zvESC_LVL_CNT_st1}{#insert zStmctRAW_M_elc}{#insert zzStpSyn}	stmctp
stmctq -- stmct, doubly-escaped (or more)	{#insert zvESC_LVL_CNT_stPrompt}{#insert zStmctRAW_M_elc}{#insert zzStpSyn}	stmctq
stmp -- stm, escaped	{#insert zvESC_LVL_CNT_st1}{#insert zStmRAW_M_elc}{#insert zzStpSyn}	stmp
stmq -- stm, doubly-escaped (or more)	{#insert zvESC_LVL_CNT_stPrompt}{#insert zStmRAW_M_elc}{#insert zzStpSyn}	stmq
stp -- {#SETPHRASE -dsc... -cntnt ... -atx...}	{#insert zvESC_LVL_CNT_st0}{#insert zStpRAW_M_elc}{#insert zzStpSyn}	stp
stpb -- {#SETPHRASE -dsc [paste] -cntnt ... -atx [paste]...}	{#insert zvESC_LVL_CNT_st0}{#insert zStpbRAW_M_elc}{#insert zzStpSyn}	stpb
stpbc -- {#SETPHRASE -dsc [paste] -cntnt [crsr] -atx [paste]...}	{#insert zvESC_LVL_CNT_st0}{#insert zStpbcRAW_M_elc}{#insert zzStpSyn}	stpbc
stpbcb -- {#SETPHRASE -dsc [paste] -cntnt {#INSERTCLIPBOARD} -atx [paste]...}	{#insert zvESC_LVL_CNT_st0}{#insert zStpbcbRAW_M_elc}{#insert zzStpSyn}	stpbcb
stpbcbp -- stpbcb, escaped	{#insert zvESC_LVL_CNT_st1}{#insert zStpbcbRAW_M_elc}{#insert zzStpSyn}	stpbcbp
stpbcbq -- stpbcb, doubly-escaped (or more)	{#insert zvESC_LVL_CNT_stPrompt}{#insert zStpbcbRAW_M_elc}{#insert zzStpSyn}	stpbcbq
stpbce -- stpbc, no content (empty-string)	{#insert zvESC_LVL_CNT_st0}{#insert zStpbceRAW_M_elc}{#insert zzStpSyn}	stpbce
stpbcep -- stpbce, escaped	{#insert zvESC_LVL_CNT_st1}{#insert zStpbceRAW_M_elc}{#insert zzStpSyn}	stpbcep
stpbceq -- stpbce, doubly-escaped (or more)	{#insert zvESC_LVL_CNT_stPrompt}{#insert zStpbceRAW_M_elc}{#insert zzStpSyn}	stpbceq
stpbcp -- stpbc, escaped	{#insert zvESC_LVL_CNT_st1}{#insert zStpbcRAW_M_elc}{#insert zzStpSyn}	stpbcp
stpbcq -- stpbc, doubly-escaped (or more)	{#insert zvESC_LVL_CNT_stPrompt}{#insert zStpbcRAW_M_elc}{#insert zzStpSyn}	stpbcq
stpbp -- stpb, escaped	{#insert zvESC_LVL_CNT_st1}{#insert zStpbRAW_M_elc}{#insert zzStpSyn}	stpbp
stpbq -- stpb, doubly-escaped (or more)	{#insert zvESC_LVL_CNT_stPrompt}{#insert zStpbRAW_M_elc}{#insert zzStpSyn}	stpbq
stpc -- {#SETPHRASE -dsc ... -cntnt [crsr] -atx ...}	{#insert zvESC_LVL_CNT_st0}{#insert zStpcRAW_M_elc}{#insert zzStpSyn}	stpc
stpcb -- {#SETPHRASE -dsc ... -cntnt [paste] -atx ...}	{#insert zvESC_LVL_CNT_st0}{#insert zStpcbRAW_M_elc}{#insert zzStpSyn}	stpcb
stpcbp -- stpcb, escaped	{#insert zvESC_LVL_CNT_st1}{#insert zStpcbRAW_M_elc}{#insert zzStpSyn}	stpcbp
stpcbq -- stpcb, doubly-escaped (or more)	{#insert zvESC_LVL_CNT_stPrompt}{#insert zStpcbRAW_M_elc}{#insert zzStpSyn}	stpcbq
stpccb -- {#SETPHRASE -dsc ... -cntnt {#INSERTCLIPBOARD} -atx ...}	{#insert zvESC_LVL_CNT_st0}{#insert zStpccbRAW_M_elc}{#insert zzStpSyn}	stpccb
stpccbp -- stpccb, escaped	{#insert zvESC_LVL_CNT_st1}{#insert zStpccbRAW_M_elc}{#insert zzStpSyn}	stpccbp
stpccbq -- stpccb, doubly-escaped (or more)	{#insert zvESC_LVL_CNT_stPrompt}{#insert zStpccbRAW_M_elc}{#insert zzStpSyn}	stpccbq
stpce -- stpc, no content (empty-string)	{#insert zvESC_LVL_CNT_st0}{#insert zStpceRAW_M_elc}{#insert zzStpSyn}	stpce
stpcep -- stpce, escaped	{#insert zvESC_LVL_CNT_st1}{#insert zStpceRAW_M_elc}{#insert zzStpSyn}	stpcep
stpceq -- stpce, doubly-escaped (or more)	{#insert zvESC_LVL_CNT_stPrompt}{#insert zStpceRAW_M_elc}{#insert zzStpSyn}	stpceq
stpcp -- stpc, escaped	{#insert zvESC_LVL_CNT_st1}{#insert zStpcRAW_M_elc}{#insert zzStpSyn}	stpcp
stpcq -- stpc, doubly-escaped (or more)	{#insert zvESC_LVL_CNT_stPrompt}{#insert zStpcRAW_M_elc}{#insert zzStpSyn}	stpcq
stpct -- {#SETPHRASE -dsc ... -cntnt {#insert [paste]} -atx ...}	{#insert zvESC_LVL_CNT_st0}{#insert zStpctRAW_M_elc}{#insert zzStpSyn}	stpct
stpctp -- stpct, escaped	{#insert zvESC_LVL_CNT_st1}{#insert zStpctRAW_M_elc}{#insert zzStpSyn}	stpctp
stpctq -- stpct, doubly-escaped (or more)	{#insert zvESC_LVL_CNT_stPrompt}{#insert zStpctRAW_M_elc}{#insert zzStpSyn}	stpctq
stpp -- stp, escaped	{#insert zvESC_LVL_CNT_st1}{#insert zStpRAW_M_elc}{#insert zzStpSyn}	stpp
stpq -- stp, doubly-escaped (or more)	{#insert zvESC_LVL_CNT_stPrompt}{#insert zStpRAW_M_elc}{#insert zzStpSyn}	stpq
zStmRAW_M_elc -- Needs zvESC_LVL_CNT (assumed good value!)	{#insert zOY_M_elc}#SETPHRASE -description {#insert zzzInpVarName} -content {#insert zXmark} -autotext {#insert zzzInpVarName} -folder ctvv_folder{#insert zCY_M_elc}	zStmRAW_M_elc
zStmcRAW_M_elc	{#insert zOY_M_elc}#SETPHRASE -description {#insert zzzInpVarName} -content  -autotext {#insert zzzInpVarName} -folder ctvv_folder{#insert zCY_M_elc}{#insert zzLeftPrevEscCrly_M_elc}{#LEFT -count 31}{#LOOP {#LEFT} -count {#LENGTH {#insert zzzInpVarName}}}	zStmcRAW_M_elc
zStmcbRAW_M_elc	{#insert zOY_M_elc}#SETPHRASE -description {#insert zzzInpVarName} -content {#insert zTPPaste} -autotext {#insert zzzInpVarName} -folder ctvv_folder{#insert zCY_M_elc}	zStmcbRAW_M_elc
zStmccbRAW_M_elc	{#insert zOY_M_elc}#SETPHRASE -description {#insert zzzInpVarName} -content \\\{#INSERTCLIPBOARD\\\} -autotext {#insert zzzInpVarName} -folder ctvv_folder{#insert zCY_M_elc}	zStmccbRAW_M_elc
zStmceRAW_M_elc	{#insert zOY_M_elc}#SETPHRASE -description {#insert zzzInpVarName} -content -autotext {#insert zzzInpVarName} -folder ctvv_folder{#insert zCY_M_elc}	zStmceRAW_M_elc
zStmctRAW_M_elc	{#insert zOY_M_elc}#SETPHRASE -description {#insert zzzInpVarName} -content \\\{#insert {#insert zTPPaste}\\\} -autotext {#insert zzzInpVarName} -folder ctvv_folder{#insert zCY_M_elc}	zStmctRAW_M_elc
zStpRAW_M_elc	{#insert zOY_M_elc}#SETPHRASE -description {#insert zXmark} -content {#insert zYmark} -autotext {#insert zXmark} -folder ctvv_folder{#insert zCY_M_elc}	zStpRAW_M_elc
zStpbRAW_M_elc	{#insert zOY_M_elc}#SETPHRASE -description {#insert zTPPaste} -content {#insert zXmark} -autotext {#insert zTPPaste} -folder ctvv_folder{#insert zCY_M_elc}	zStpbRAW_M_elc
zStpbcRAW_M_elc	{#insert zOY_M_elc}#SETPHRASE -description {#insert zTPPaste} -content  -autotext {#insert zTPPaste} -folder ctvv_folder{#insert zCY_M_elc}{#insert zzLeftPrevEscCrly_M_elc}{#LEFT -count 31}{#LOOP {#LEFT} -count {#LENGTH {#INSERTCLIPBOARD}}}	zStpbcRAW_M_elc
zStpbcbRAW_M_elc	{#insert zOY_M_elc}#SETPHRASE -description {#insert zTPPaste} -content \\\{#INSERTCLIPBOARD\\\} -autotext {#insert zTPPaste} -folder ctvv_folder{#insert zCY_M_elc}	zStpbcbRAW_M_elc
zStpbceRAW_M_elc	{#insert zOY_M_elc}#SETPHRASE -description {#insert zTPPaste} -content -autotext {#insert zTPPaste} -folder ctvv_folder{#insert zCY_M_elc}	zStpbceRAW_M_elc
zStpcRAW_M_elc	{#insert zOY_M_elc}#SETPHRASE -description {#insert zXmark} -content  -autotext {#insert zXmark} -folder ctvv_folder{#insert zCY_M_elc}{#insert zzLeftPrevEscCrly_M_elc}{#LEFT -count 34}	zStpcRAW_M_elc
zStpcbRAW_M_elc	{#insert zOY_M_elc}#SETPHRASE -description {#insert zXmark} -content {#insert zTPPaste} -autotext {#insert zXmark} -folder ctvv_folder{#insert zCY_M_elc}	zStpcbRAW_M_elc
zStpccbRAW_M_elc	{#insert zOY_M_elc}#SETPHRASE -description {#insert zXmark} -content \\\{#INSERTCLIPBOARD\\\} -autotext {#insert zXmark} -folder ctvv_folder{#insert zCY_M_elc}	zStpccbRAW_M_elc
zStpceRAW_M_elc	{#insert zOY_M_elc}#SETPHRASE -description {#insert zXmark} -content -autotext {#insert zXmark} -folder ctvv_folder{#insert zCY_M_elc}	zStpceRAW_M_elc
zStpctRAW_M_elc	{#insert zOY_M_elc}#SETPHRASE -description {#insert zXmark} -content \\\{#insert {#insert zTPPaste}\\\} -autotext {#insert zXmark} -folder ctvv_folder{#insert zCY_M_elc}	zStpctRAW_M_elc
zzPccStpAllMainAbrvs1CQBL	[Stm][Stmc][Stmcb][Stmccb][Stmce][Stmct][Stp][Stpb][Stpbc][Stpbcb][Stpbce][Stpc][Stpcb][Stpccb][Stpce][Stpct]	zzPccStpAllMainAbrvs1CQBL
zzStpSyn	{#BALLOON -title SETPHRASE (stp) syntax -text stp[b[c[b,e]]], stpc[[b,c[b,e],t]], stm[c[[b,c[b,e],t]]]  // [b]=paste clipboard, [cb (incl. 'stpbcb')]=\\\{#INSCB\\\}, [e]=content~value is empty~string, [t]=\\\{#ins [paste]\\\}  //  All have [[p,q]] option ~~ [p]=esc'd, [q]=dbly~esc'd (or more)  //  pccstptestall}	zzStpSyn
zzzInpVarName	{#INPUT -head Variable name? -def zv -single}	zzzInpVarName
