__XBN-PhraseExpress is released under the LGPL 2.1	(*XBN-PhraseExpress: Large set of generically useful scripting tools for MS Windows, written in PhraseExpress and TextPad.  //  Copyright (C) 2013 Jeff Epstein  //  This library is free software; you can redistribute it and/or modify it under the terms of the GNU Lesser General Public License as published by the Free Software Foundation; either version 2.1 of the License, or (at your option) any later version.  //  This library is distributed in the hope that it will be useful, but WITHOUT ANY WARRANTY; without even the implied warranty of MERCHANTABILITY or FITNESS FOR A PARTICULAR PURPOSE. See the GNU Lesser General Public License for more details.  //  You should have received a copy of the GNU Lesser General Public License along with this library; if not, write to the Free Software Foundation, Inc., 51 Franklin Street, Fifth Floor, Boston, MA 02110-1301 USA*)		(*Two tabs plus this comment, to force this phrase to be (a) imported, and (b) with NO autotext*)
zzZIdxJavaCatNameLong	XBN-PhraseExpress: Java	zzZIdxJavaCatNameLong
zzZIdxJavaCatNameShort	XBNPE>Java	zzZIdxJavaCatNameShort
zzZIdxJavaChildCountCat	3	zzZIdxJavaChildCountCat
zzZIdxJavaChildCountPset	0	zzZIdxJavaChildCountPset
zzZIdxJavaChildTCPostsQBLCat -- PHRASE CALLS, NOT LITERAL TEXT	[{#insert zzZIdxJdlPostTC}][{#insert zzZIdxJgxPostTC}][{#insert zzZIdxJgnPostTC}]	zzZIdxJavaChildTCPostsQBLCat
zzZIdxJavaChildTCPostsQBLPset -- PHRASE CALLS, NOT LITERAL TEXT		zzZIdxJavaChildTCPostsQBLPset
zzZIdxJavaDescription	Phrases for creating and navigation Java code.	zzZIdxJavaDescription
zzZIdxJavaNodeType -- DO NOT EDIT	cat	zzZIdxJavaNodeType
zzZIdxJavaPNAbrvTC -- DO NOT EDIT	Java	zzZIdxJavaPNAbrvTC
zzZIdxJavaParentTCPost -- LITERAL TEXT, NOT PHRASE CALL	Xbnpe	zzZIdxJavaParentTCPost
zzZIdxJavaPostTC -- DO NOT EDIT	Java	zzZIdxJavaPostTC
zzZIdxJavaPostfix	java	zzZIdxJavaPostfix
zzZIdxJavaXInfo_onff	off	zzZIdxJavaXInfo_onff

zzZIdxJdlNodeType -- DO NOT EDIT	cat	zzZIdxJdlNodeType
zzZIdxJdlinkPNAbrvTC -- DO NOT EDIT	Jdl	zzZIdxJdlinkPNAbrvTC
zzZIdxJdlPostfix	jdlink	zzZIdxJdlPostfix
zzZIdxJdlPostTC -- DO NOT EDIT	Jdlink	zzZIdxJdlPostTC
zzZIdxJdlParentTCPost -- LITERAL TEXT, NOT PHRASE CALL	Java	zzZIdxJdlParentTCPost
zzZIdxJdlCatNameShort	Create JD-Link	zzZIdxJdlCatNameShort
zzZIdxJdlCatNameLong	Create JavaDoc Link: Func, Cnstr, File, Obj	zzZIdxJdlCatNameLong
zzZIdxJdlChildCountCat	5	zzZIdxJdlChildCountCat
zzZIdxJdlChildTCPostsQBLCat -- PHRASE CALLS, NOT LITERAL TEXT	[__OPEN_CURLY__#insert zzZIdxJdlwcPostfix}][__OPEN_CURLY__#insert zzZIdxJdlwfPostfix}][__OPEN_CURLY__#insert zzZIdxJdlnpfPostfix}][__OPEN_CURLY__#insert zzZIdxJdlnpcPostfix}][__OPEN_CURLY__#insert zzZIdxJdlnpioPostfix}]	zzZIdxJdlChildTCPostsQBLCat
zzZIdxJdlChildCountPset	0	zzZIdxJdlChildCountPset
zzZIdxJdlChildTCPostsQBLPset -- PHRASE CALLS, NOT LITERAL TEXT		zzZIdxJdlChildTCPostsQBLPset
zzZIdxJdlDescription	Create a JavaDoc link to a functions or constructor (with or without parameters), or to a file or object.	zzZIdxJdlDescription
zzZIdxJdlXInfo_onff	off	zzZIdxJdlXInfo_onff
zzZIdxJdlExtraInfo		zzZIdxJdlExtraInfo

