__XBN-PhraseExpress is released under the LGPL 2.1	(*XBN-PhraseExpress: Large set of generically useful scripting tools for MS Windows, written in PhraseExpress and TextPad.  //  Copyright (C) 2013 Jeff Epstein  //  This library is free software; you can redistribute it and/or modify it under the terms of the GNU Lesser General Public License as published by the Free Software Foundation; either version 2.1 of the License, or (at your option) any later version.  //  This library is distributed in the hope that it will be useful, but WITHOUT ANY WARRANTY; without even the implied warranty of MERCHANTABILITY or FITNESS FOR A PARTICULAR PURPOSE. See the GNU Lesser General Public License for more details.  //  You should have received a copy of the GNU Lesser General Public License along with this library; if not, write to the Free Software Foundation, Inc., 51 Franklin Street, Fifth Floor, Boston, MA 02110-1301 USA*)		(*Two tabs plus this comment, to force this phrase to be (a) imported, and (b) with NO autotext*)

(*---------------------------------------------------------------*)
zzZIdxJgkmwNodeType -- DO NOT EDIT	pset	zzZIdxJgkmwNodeType
zzZIdxJfgplinkmwPNAbrvTC -- DO NOT EDIT	Jgkmw	zzZIdxJfgplinkmwPNAbrvTC
zzZIdxJgkmwPostfix	jfgplinkmw	zzZIdxJgkmwPostfix
zzZIdxJgkmwPostTC -- DO NOT EDIT	Jfgplinkmw	zzZIdxJgkmwPostTC
zzZIdxJgkmwParentTCPost -- LITERAL TEXT, NOT PHRASE CALL	Jfgfromname	zzZIdxJgkmwParentTCPost
zzZIdxJgkmwSyntax	mw[c]pkg[[n,t,y]] ... mw[c]pkmrg[[n,t,y]] ... mw[c]pkp[[n,t,y]]	zzZIdxJgkmwSyntax
zzZIdxJgkmwDescription	For the function-name in the url of the 'P'revious lin'K', print its signature at the cursor. ('M'ark the current cursor position [with a y-mark: '{#insert zYmark}'], go-to-and-copy the signature, then 'W'rite it back at the mark.)	zzZIdxJgkmwDescription
zzZIdxJgkmwXInfo_onff	on	zzZIdxJgkmwXInfo_onff
zzZIdxJgkmwExtraInfo	{#insert zzAllOptsEntrTb}{#insert zzJgOptInfoC}{#insert zzJgOptInfoG}{#insert zzJgOptInfoM}{#insert zzJgOptInfoN}{#insert zzJgOptInfoP}{#insert zzJgOptInfoR}{#insert zzJgOptInfoT}{#insert zzJgOptInfoY}{#insert zzPhraseFileNameFooter}{#insert zXPROOT_DIR_jFuncSig}jfsig_for_prev_url_func_name_mw.px.txt	zzZIdxJgkmwExtraInfo

(*---------------------------------------------------------------*)
zzZIdxJgkgNodeType -- DO NOT EDIT	pset	zzZIdxJgkgNodeType
zzZIdxJfgplinkgtPNAbrvTC -- DO NOT EDIT	Jgkg	zzZIdxJfgplinkgtPNAbrvTC
zzZIdxJgkgPostfix	jfgplinkgt	zzZIdxJgkgPostfix
zzZIdxJgkgPostTC -- DO NOT EDIT	Jfgplinkgt	zzZIdxJgkgPostTC
zzZIdxJgkgParentTCPost -- LITERAL TEXT, NOT PHRASE CALL	Jfgfromname	zzZIdxJgkgParentTCPost
zzZIdxJgkgSyntax	gtpkmc[p,[r]g] ... gtpkm[g,p]	zzZIdxJgkgSyntax
zzZIdxJgkgDescription	For the function-name in the url of the 'P'revious lin'K', go to its signature. ({#insert zzJgAddtnlPromptFuncsMsg} See 'zidxjfgplinkgtx'.)	zzZIdxJgkgDescription
zzZIdxJgkgXInfo_onff	on	zzZIdxJgkgXInfo_onff
zzZIdxJgkgExtraInfo	{#insert zzAllOptsEntrTb}{#insert zzJgOptInfoC}{#insert zzJgOptInfoG}{#insert zzJgOptInfoM}{#insert zzJgOptInfoP}{#insert zzJgOptInfoR}{#insert zzJgOptInfoPromptPost_preSyntax}gtpkm[f,p,[r]g]prompt{#insert zzJgOptInfoPromptPost_postSyntax}{#insert zzPhraseFileNameFooter}{#insert zXPROOT_DIR_jFuncSig}jfsig_for_prev_url_func_name_gt.px.txt	zzZIdxJgkgExtraInfo

(*---------------------------------------------------------------*)
zzZIdxJgpwNodeType -- DO NOT EDIT	pset	zzZIdxJgpwNodeType
zzZIdxJfgprevwordPNAbrvTC -- DO NOT EDIT	Jgpw	zzZIdxJfgprevwordPNAbrvTC
zzZIdxJgpwPostfix	jfgprevword	zzZIdxJgpwPostfix
zzZIdxJgpwPostTC -- DO NOT EDIT	Jfgprevword	zzZIdxJgpwPostTC
zzZIdxJgpwParentTCPost -- LITERAL TEXT, NOT PHRASE CALL	Jfgfromname	zzZIdxJgpwParentTCPost
zzZIdxJgpwSyntax	mppw[[n,t,y]] ... gtpw[f,g,p,rg][m] ... scpw[g,p,rg][m]	zzZIdxJgpwSyntax
zzZIdxJgpwDescription	For the function-name in the 'P'revious 'W'ord, go to its signature, or select-copy it, or write it at the cursor.	zzZIdxJgpwDescription
zzZIdxJgpwXInfo_onff	on	zzZIdxJgpwXInfo_onff
zzZIdxJgpwExtraInfo	{#insert zzAllOptsEntrTb}{#insert zzJgOptInfoC}{#insert zzJgOptInfoF}{#insert zzJgOptInfoG}{#insert zzJgOptInfoM}{#insert zzJgOptInfoN}{#insert zzJgOptInfoP}{#insert zzJgOptInfoR}{#insert zzJgOptInfoT}{#insert zzJgOptInfoY}{#insert zzPhraseFileNameFooter}{#insert zXPROOT_DIR_jFuncSig}jfsig_for_prev_word_func_name.px.txt	zzZIdxJgpwExtraInfo

(*---------------------------------------------------------------*)
zzZIdxJgcbNodeType -- DO NOT EDIT	pset	zzZIdxJgcbNodeType
zzZIdxJfgcbnamePNAbrvTC -- DO NOT EDIT	Jgcb	zzZIdxJfgcbnamePNAbrvTC
zzZIdxJgcbPostfix	jfgcbname	zzZIdxJgcbPostfix
zzZIdxJgcbPostTC -- DO NOT EDIT	Jfgcbname	zzZIdxJgcbPostTC
zzZIdxJgcbParentTCPost -- LITERAL TEXT, NOT PHRASE CALL	Jfgfromname	zzZIdxJgcbParentTCPost
zzZIdxJgcbSyntax	gtcb[p][g] ... gtcbm[c][g,p,rg] ... mwc[c]b[g,p,rg][[n,t,y]] ... sccb[m[c]][g,p,rg]	zzZIdxJgcbSyntax
zzZIdxJgcbDescription	For the function name in the 'C'lip'B'oard, go to its signature, or select-copy it, or 'W'rite it at the cursor. ({#insert zzJgAddtnlPromptFuncsMsg} See 'zidxjgcbnamex'.)	zzZIdxJgcbDescription
zzZIdxJgcbXInfo_onff	on	zzZIdxJgcbXInfo_onff
zzZIdxJgcbExtraInfo	{#insert zzAllOptsEntrTb}{#insert zzJgOptInfoC}{#insert zzJgOptInfoG}{#insert zzJgOptInfoM}{#insert zzJgOptInfoN}{#insert zzJgOptInfoP}{#insert zzJgOptInfoR}{#insert zzJgOptInfoT}{#insert zzJgOptInfoY}{#insert zzJgOptInfoPromptPost_preSyntax}gtcb[m[c]][[p,[r]g]][prompt] ... sccbg[c[p,[r]g]][prompt] ... sccbm[[p,[r]g]][prompt] ... sccb[p,rg][prompt]{#insert zzJgOptInfoPromptPost_postSyntax}{#insert zzPhraseFileNameFooter}{#insert zXPROOT_DIR_jFuncSig}jfsig_for_func_name_in_cb.px.txt	zzZIdxJgcbExtraInfo

(*---------------------------------------------------------------*)
zzZIdxJgpnmwNodeType -- DO NOT EDIT	pset	zzZIdxJgpnmwNodeType
zzZIdxJfgpnmarkwritePNAbrvTC -- DO NOT EDIT	Jgpnmw	zzZIdxJfgpnmarkwritePNAbrvTC
zzZIdxJgpnmwPostfix	jfgpnmarkwrite	zzZIdxJgpnmwPostfix
zzZIdxJgpnmwPostTC -- DO NOT EDIT	Jfgpnmarkwrite	zzZIdxJgpnmwPostTC
zzZIdxJgpnmwParentTCPost -- LITERAL TEXT, NOT PHRASE CALL	Jfgnext	zzZIdxJgpnmwParentTCPost
zzZIdxJgpnmwSyntax	mw[c][[r]g,p][[n,t,y]][l,z] ... mw[c]r[t,y,yh][l,z] ... sprg[l,z][k[np]][c] ... thisfn[l,z][c,q[h]]	zzZIdxJgpnmwSyntax
zzZIdxJgpnmwDescription	For the signature just above ('L') or below ('Z'), write it at the cursor. ('M'ark the current cursor location, copy the signature, then 'W'rite it at the cursor.) 'sprg*' is the same as 'mw*', but ignores the signature's function (constructor) name, and uses the super-class-name in its place. This phrase-set also contains the 'thisfn' utility function, which retrieves the function name only.	zzZIdxJgpnmwDescription
zzZIdxJgpnmwXInfo_onff	on	zzZIdxJgpnmwXInfo_onff
zzZIdxJgpnmwExtraInfo	{#insert zzAllOptsEntrTb}{#insert zzJgOptInfoC}{#insert zzJgOptInfoG}{#insert zzJgOptInfoHafterQ}{#insert zzJgOptInfoHafterY}{#insert zzJgOptInfoK}{#insert zzJgOptInfoL}{#insert zzJgOptInfoN}{#insert zzJgOptInfoP}{#insert zzJgOptInfoQ}{#insert zzJgOptInfoR}{#insert zzJgOptInfoT}{#insert zzJgOptInfoY}{#insert zzJgOptInfoZ}{#insert zzPhraseFileNameFooter}{#insert zXPROOT_DIR_jFuncSig}jfsig_prev_next__go_to_sel_copy.px.txt	zzZIdxJgpnmwExtraInfo

(*---------------------------------------------------------------*)
zzZIdxJgpnsNodeType -- DO NOT EDIT	pset	zzZIdxJgpnsNodeType
zzZIdxJfgpnselcopyPNAbrvTC -- DO NOT EDIT	Jgpns	zzZIdxJfgpnselcopyPNAbrvTC
zzZIdxJgpnsPostfix	jfgpnselcopy	zzZIdxJgpnsPostfix
zzZIdxJgpnsPostTC -- DO NOT EDIT	Jfgpnselcopy	zzZIdxJgpnsPostTC
zzZIdxJgpnsParentTCPost -- LITERAL TEXT, NOT PHRASE CALL	Jfgnext	zzZIdxJgpnsParentTCPost
zzZIdxJgpnsSyntax	sc[m[c]][g,p][l,z] ... sc[m[c]]r[g,t,y][l,z] ... gt[m[c]][g,p,rg][l,z]	zzZIdxJgpnsSyntax
zzZIdxJgpnsDescription	'G'o 'T'o, and then 'S'elect-and-'C'opy, the signature just above ('L') or below ('Z') the cursor.	zzZIdxJgpnsDescription
zzZIdxJgpnsXInfo_onff	on	zzZIdxJgpnsXInfo_onff
zzZIdxJgpnsExtraInfo	{#insert zzAllOptsEntrTb}{#insert zzJgOptInfoC}{#insert zzJgOptInfoG}{#insert zzJgOptInfoHafterY}{#insert zzJgOptInfoL}{#insert zzJgOptInfoM}{#insert zzJgOptInfoP}{#insert zzJgOptInfoR}{#insert zzJgOptInfoT}{#insert zzJgOptInfoY}{#insert zzJgOptInfoZ}{#insert zzPhraseFileNameFooter}{#insert zXPROOT_DIR_jFuncSig}jfsig_prev_next__go_to_sel_copy.px.txt	zzZIdxJgpnsExtraInfo

(*---------------------------------------------------------------*)

