__XBN-PhraseExpress is released under the LGPL 2.1	(*XBN-PhraseExpress is a large set of generically-useful Microsoft Windows scripting tools, written in PhraseExpress, using the plain-text editor TextPad as its foundation.  //  Copyright (C) 2013 Jeff Epstein  //  This library is free software; you can redistribute it and/or modify it under the terms of the GNU Lesser General Public License as published by the Free Software Foundation; either version 2.1 of the License, or (at your option) any later version.  //  This library is distributed in the hope that it will be useful, but WITHOUT ANY WARRANTY; without even the implied warranty of MERCHANTABILITY or FITNESS FOR A PARTICULAR PURPOSE. See the GNU Lesser General Public License for more details.  //  You should have received a copy of the GNU Lesser General Public License along with this library; if not, write to the Free Software Foundation, Inc., 51 Franklin Street, Fifth Floor, Boston, MA 02110-1301 USA*)		(*Two tabs plus this comment, to force this phrase to be (a) imported, and (b) with NO autotext*)
ggcbfadg -- ggcbfadg0p ALT KC	{#insert ggcbfadg0p}	ggcbfadg
ggcbfadg0p -- ggcbfadg, zero-or-more (0-Plus) parameters	{#insert zjreSetPCountPost_0orMore}{#insert zggcbfadg_MASTER}	ggcbfadg0p
ggcbfadg1	{#insert zjreSetPCountPost_1}{#insert zggcbfadg_MASTER}	ggcbfadg1
ggcbfadg1p -- ggcbfadg, one-or-more (1-Plus) parameters	{#insert zjreSetPCountPost_1orMore}{#insert zggcbfadg_MASTER}	ggcbfadg1p
ggcbfadg2	{#insert zjreSetPCountPost_2}{#insert zggcbfadg_MASTER}	ggcbfadg2
ggcbfadg3	{#insert zjreSetPCountPost_3}{#insert zggcbfadg_MASTER}	ggcbfadg3
ggcbfadg4	{#insert zjreSetPCountPost_4}{#insert zggcbfadg_MASTER}	ggcbfadg4
ggcbfadg5	{#insert zjreSetPCountPost_5}{#insert zggcbfadg_MASTER}	ggcbfadg5
ggcbfadgn -- prompt for exact param-count	{#insert zjreSetPCountPost_FromGT0Prompt}{#insert zggcbfadg_MASTER}	ggcbfadgn
ggcbqfadg -- ggcbfadg	{#insert zggcbqGTCutName}{#insert ggcbfadg}	ggcbqfadg
ggcbqfadg0p -- ggcbfadg0p	{#insert zggcbqGTCutName}{#insert ggcbfadg0p}	ggcbqfadg0p
ggcbqfadg1 -- ggcbfadg1	{#insert zggcbqGTCutName}{#insert ggcbfadg1}	ggcbqfadg1
ggcbqfadg1p -- ggcbfadg1p	{#insert zggcbqGTCutName}{#insert ggcbfadg1p}	ggcbqfadg1p
ggcbqfadg2 -- ggcbfadg2	{#insert zggcbqGTCutName}{#insert ggcbfadg2}	ggcbqfadg2
ggcbqfadg3 -- ggcbfadg3	{#insert zggcbqGTCutName}{#insert ggcbfadg3}	ggcbqfadg3
ggcbqfadg4 -- ggcbfadg4	{#insert zggcbqGTCutName}{#insert ggcbfadg4}	ggcbqfadg4
ggcbqfadg5 -- ggcbfadg5	{#insert zggcbqGTCutName}{#insert ggcbfadg5}	ggcbqfadg5
ggcbqfadgn -- ggcbfadgn	{#insert zzggcGTDN}{#insert ggcbqfadgn}	gnggcbqfadgn
ggpwfadg -- zCutL1w, ggcbfadg	{#insert zCutL1w}{#insert ggcbfadg}	ggpwfadg
ggpwfadg0p -- zCutL1w, ggcbfadg0p	{#insert zCutL1w}{#insert ggcbfadg0p}	ggpwfadg0p
ggpwfadg1 -- zCutL1w, ggcbfadg1	{#insert zCutL1w}{#insert ggcbfadg1}	ggpwfadg1
ggpwfadg1p -- zCutL1w, ggcbfadg1p	{#insert zCutL1w}{#insert ggcbfadg1p}	ggpwfadg1p
ggpwfadg2 -- zCutL1w, ggcbfadg2	{#insert zCutL1w}{#insert ggcbfadg2}	ggpwfadg2
ggpwfadg3 -- zCutL1w, ggcbfadg3	{#insert zCutL1w}{#insert ggcbfadg3}	ggpwfadg3
ggpwfadg4 -- zCutL1w, ggcbfadg4	{#insert zCutL1w}{#insert ggcbfadg4}	ggpwfadg4
ggpwfadg5 -- zCutL1w, ggcbfadg5	{#insert zCutL1w}{#insert ggcbfadg5}	ggpwfadg5
ggpwfadgn -- zCutL1w, ggcbfadgn	{#insert zCutL1w}{#insert ggcbfadgn}	ggpwfadgn
