ggcbfr -- ggcbfr0p ALT KC	{#insert ggcbfr0p}	ggcbfr
ggcbfr0p -- ggcbfr, zero-or-more (0-Plus) parameters	{#insert zjreSetPCountPost_0orMore}{#insert zggcbfr_MASTER}	ggcbfr0p
ggcbfr1	{#insert zjreSetPCountPost_1}{#insert zggcbfr_MASTER}	ggcbfr1
ggcbfr1p -- ggcbfr, one-or-more (1-Plus) parameters	{#insert zjreSetPCountPost_1orMore}{#insert zggcbfr_MASTER}	ggcbfr1p
ggcbfr2	{#insert zjreSetPCountPost_2}{#insert zggcbfr_MASTER}	ggcbfr2
ggcbfr3	{#insert zjreSetPCountPost_3}{#insert zggcbfr_MASTER}	ggcbfr3
ggcbfr4	{#insert zjreSetPCountPost_4}{#insert zggcbfr_MASTER}	ggcbfr4
ggcbfr5	{#insert zjreSetPCountPost_5}{#insert zggcbfr_MASTER}	ggcbfr5
ggcbfrn -- prompt for exact param-count	{#insert zjreSetPCountPost_FromGT0Prompt}{#insert zggcbfr_MASTER}	ggcbfrn
ggcbqfr -- ggcbfr	{#insert zggcbqGTCutName}{#insert ggcbfr}	ggcbqfr
ggcbqfr0p -- ggcbfr0p	{#insert zggcbqGTCutName}{#insert ggcbfr0p}	ggcbqfr0p
ggcbqfr1 -- ggcbfr1	{#insert zggcbqGTCutName}{#insert ggcbfr1}	ggcbqfr1
ggcbqfr1p -- ggcbfr1p	{#insert zggcbqGTCutName}{#insert ggcbfr1p}	ggcbqfr1p
ggcbqfr2 -- ggcbfr2	{#insert zggcbqGTCutName}{#insert ggcbfr2}	ggcbqfr2
ggcbqfr3 -- ggcbfr3	{#insert zggcbqGTCutName}{#insert ggcbfr3}	ggcbqfr3
ggcbqfr4 -- ggcbfr4	{#insert zggcbqGTCutName}{#insert ggcbfr4}	ggcbqfr4
ggcbqfr5 -- ggcbfr5	{#insert zggcbqGTCutName}{#insert ggcbfr5}	ggcbqfr5
ggcbqfrn -- ggcbfrn	{#insert zggcbqGTCutName}{#insert ggcbfrn}	ggcbqfrn
ggpwfr -- zCutL1w, ggcbfr	{#insert zCutL1w}{#insert ggcbfr}	ggpwfr
ggpwfr0p -- zCutL1w, ggcbfr0p	{#insert zCutL1w}{#insert ggcbfr0p}	ggpwfr0p
ggpwfr1 -- zCutL1w, ggcbfr1	{#insert zCutL1w}{#insert ggcbfr1}	ggpwfr1
ggpwfr1p -- zCutL1w, ggcbfr1p	{#insert zCutL1w}{#insert ggcbfr1p}	ggpwfr1p
ggpwfr2 -- zCutL1w, ggcbfr2	{#insert zCutL1w}{#insert ggcbfr2}	ggpwfr2
ggpwfr3 -- zCutL1w, ggcbfr3	{#insert zCutL1w}{#insert ggcbfr3}	ggpwfr3
ggpwfr4 -- zCutL1w, ggcbfr4	{#insert zCutL1w}{#insert ggcbfr4}	ggpwfr4
ggpwfr5 -- zCutL1w, ggcbfr5	{#insert zCutL1w}{#insert ggcbfr5}	ggpwfr5
ggpwfrn -- zCutL1w, ggcbfrn	{#insert zCutL1w}{#insert ggcbfrn}	ggpwfrn
