ggcbfinfo	{#insert zFcsTPFileNew}ggcbf*: More Info{#insert zENTER2}All signatures that match are listed in the Search Results. Go into the correct java file, and press [find-next] or [find-prev] until the cursor is in the correct signature line. When it is, click [OK]. The signature will then be properly selected and copied (along with other actions if-and-as requested).{#insert zENTER2}To return to the original document-and-cursor location, without copying anything, click [Cancel].{#insert zENTER2}NOTES:{#insert zEnterTab}- If you open one of these files, and it's NOT the one containing the correct signature, Close it immediately.{#insert zEnter}- When the Find-in-files dialog is searching, a pop-up says to press the button when the search completes. You can actually press it as soon as the correct signature is found. Just wait until the Find-in-files dialog closes, and the ggcbf ok/cancel dialog appears before proceeding.{#insert zEnter}- [For ggcbfp* and ggcbfr* only] If you're going to click [OK], then{#insert zENTER}{#insert zTAB}(1) when you do, I'm going to close two files--so this will work if only the Search Results (which must be displayed in the main document-window--not docked) and the correct-signature-containing java file are open (and are the only ones that have been viewed since the ggcbf* macro was called).{#insert zENTER}(2) The sig-containing java file may not have unsaved changes (so save it).{#insert zEnterBkspBksp}{#insert zMoreInfoTrblPrcdDlgCloseFile}	ggcbfinfo
zCloseTwoFiles	{#insert zFcsTPFileClose}{#insert zFcsTPFileClose}	zCloseTwoFiles
zggcbfDialogProceed	{#insert zggcbfDialogProceed{#insert zvggcbfDLG_PROCEED_ON_OFF}}	zggcbfDialogProceed
zggcbfDialogProceedOFF	{#sleep 5}	zggcbfDialogProceedOFF
zggcbfDialogProceedON	{#msgbox -head Proceed? Directory set to zggcbfDefaultJavaDir.{#insert zMsgProceedOrNot}}	zggcbfDialogProceedON
zggcbfDlgProceedSetOFF	{#SETPHRASE -description zvggcbfDLG_PROCEED_ON_OFF -content OFF -autotext zvggcbfDLG_PROCEED_ON_OFF -folder ctvv_folder}	zggcbfDlgProceedSetOFF
zggcbfDlgProceedSetON	{#SETPHRASE -description zvggcbfDLG_PROCEED_ON_OFF -content ON -autotext zvggcbfDLG_PROCEED_ON_OFF -folder ctvv_folder}	zggcbfDlgProceedSetON
zggcbfSelSigCopyREoffClose2YDelete	{#insert zUpGsscgREoffUndoClose2Files}{#insert zYDownUpDelete}	zggcbfSelSigCopyREoffClose2YDelete
zggcbfSelSigCopyREoffClose2YPaste	{#insert zUpGsscgREoffUndoClose2Files}{#insert zYDownUpPaste}	zggcbfSelSigCopyREoffClose2YPaste
zggcbfSetOkTGT_g	{#SETPHRASE -description zvggcbALL_MASTER_OK_TGT -content zUpGsscgREoff -autotext zvggcbALL_MASTER_OK_TGT -folder ctvv_folder}	zggcbfSetOkTGT_g
zggcbfSetOkTGT_p	{#SETPHRASE -description zvggcbALL_MASTER_OK_TGT -content zggcbfSelSigCopyREoffClose2YPaste -autotext zvggcbALL_MASTER_OK_TGT -folder ctvv_folder}	zggcbfSetOkTGT_p
zggcbfSetOkTGT_r	{#SETPHRASE -description zvggcbALL_MASTER_OK_TGT -content zggcbfSelSigCopyREoffClose2YDelete -autotext zvggcbALL_MASTER_OK_TGT -folder ctvv_folder}	zggcbfSetOkTGT_r
zggcbf_ALL_MASTER	{#insert zYmark}{#insert zzggcbFFindCorrectSignature}	zggcbf_ALL_MASTER
zggcbfadg_MASTER	{#insert zggcbfDlgProceedSetON}{#insert zggcbfSetOkTGT_g}{#insert zggcbf_ALL_MASTER}	zggcbfadg_MASTER
zggcbfadp_MASTER	{#insert zggcbfDlgProceedSetON}{#insert zggcbfSetOkTGT_p}{#insert zggcbf_ALL_MASTER}	zggcbfadp_MASTER
zggcbfadr_MASTER	{#insert zggcbfDlgProceedSetON}{#insert zggcbfSetOkTGT_r}{#insert zggcbf_ALL_MASTER}	zggcbfadr_MASTER
zggcbfg_MASTER	{#insert zggcbfDlgProceedSetOFF}{#insert zggcbfSetOkTGT_g}{#insert zggcbf_ALL_MASTER}	zggcbfg_MASTER
zggcbfp_MASTER	{#insert zggcbfDlgProceedSetOFF}{#insert zggcbfSetOkTGT_p}{#insert zggcbf_ALL_MASTER}	zggcbfp_MASTER
zggcbfr_MASTER	{#insert zggcbfDlgProceedSetOFF}{#insert zggcbfSetOkTGT_r}{#insert zggcbf_ALL_MASTER}	zggcbfr_MASTER
zzggcbFFindCorrectSignature	{#insert zFFindOpenAMRE}{#insert zjreSetGetSigForFuncInCBForParamCount}{#insert zFFindSetJavaFilesRAW}{#insert zFFindFieldDirP4R}{#insert zggcbfDefaultJavaDir}(*{#insert zggcbfDialogProceed}*){#insert zFFindGoPMBResetRAW}{#insert zFFindAMClose}{#msgbox -head Proceed? -text {#insert zggcbKCMoreInfoPreMsg}ggcbfinfo. // ***NOTE*** If the correct java file happens to be the same one from which you called this ggcbf* macro, then use [No]. This will select and copy the signature, but do nothing else. -yes {#insert zvggcbALL_MASTER_OK_TGT} -no zUpGsscgREoff -cancel zYDownUpDelete -defaultyes}	zzggcbFFindCorrectSignature
zUpGsscgREoffUndoClose2Files	{#insert zUpGsscgREoff}{#insert zTPUndo}{#insert zCloseTwoFiles}	zUpGsscgREoffUndoClose2Files