__XBN-PhraseExpress is released under the LGPL 2.1	(*XBN-PhraseExpress is a large set of generically-useful Microsoft Windows scripting tools, written in PhraseExpress, using the plain-text editor TextPad as its foundation.  //  Copyright (C) 2013 Jeff Epstein  //  This library is free software; you can redistribute it and/or modify it under the terms of the GNU Lesser General Public License as published by the Free Software Foundation; either version 2.1 of the License, or (at your option) any later version.  //  This library is distributed in the hope that it will be useful, but WITHOUT ANY WARRANTY; without even the implied warranty of MERCHANTABILITY or FITNESS FOR A PARTICULAR PURPOSE. See the GNU Lesser General Public License for more details.  //  You should have received a copy of the GNU Lesser General Public License along with this library; if not, write to the Free Software Foundation, Inc., 51 Franklin Street, Fifth Floor, Boston, MA 02110-1301 USA*)		(*Two tabs plus this comment, to force this phrase to be (a) imported, and (b) with NO autotext*)
clpwcefk -- clpwc, prefk	{#insert zzjlCodeOnPrekEF}{#insert zzClpwPostPrek}	clpwcefk
clpwcefky -- clpwc, prefky	{#insert zzjlCodeOnPrekEFY}{#insert zzClpwPostPrek}	clpwcefky
clpwcerk -- clpwc, prerk	{#insert zzjlCodeOnPrekER}{#insert zzClpwPostPrek}	clpwcerk
clpwcerky -- clpwc, prerky	{#insert zzjlCodeOnPrekERY}{#insert zzClpwPostPrek}	clpwcerky
clpwcifk -- clpwc, prifk	{#insert zzjlCodeOnPrekIF}{#insert zzClpwPostPrek}	clpwcifk
clpwcifky -- clpwc, prifky	{#insert zzjlCodeOnPrekIFY}{#insert zzClpwPostPrek}	clpwcifky
clpwcirk -- clpwc, prirk	{#insert zzjlCodeOnPrekIR}{#insert zzClpwPostPrek}	clpwcirk
clpwcirky -- clpwc, prirky	{#insert zzjlCodeOnPrekIRY}{#insert zzClpwPostPrek}	clpwcirky
clpwdbcefk -- clpwdbc, prefk	{#insert zzjlCodeOnPrekEF}{#insert zzClpwdbPostPrek}	clpwdbcefk
clpwdbcefky -- clpwdbc, prefky	{#insert zzjlCodeOnPrekEFY}{#insert zzClpwdbPostPrek}	clpwdbcefky
clpwdbcerk -- clpwdbc, prerk	{#insert zzjlCodeOnPrekER}{#insert zzClpwdbPostPrek}	clpwdbcerk
clpwdbcerky -- clpwdbc, prerky	{#insert zzjlCodeOnPrekERY}{#insert zzClpwdbPostPrek}	clpwdbcerky
clpwdbcifk -- clpwdbc, prifk	{#insert zzjlCodeOnPrekIF}{#insert zzClpwdbPostPrek}	clpwdbcifk
clpwdbcifky -- clpwdbc, prifky	{#insert zzjlCodeOnPrekIFY}{#insert zzClpwdbPostPrek}	clpwdbcifky
clpwdbcirk -- clpwdbc, prirk	{#insert zzjlCodeOnPrekIR}{#insert zzClpwdbPostPrek}	clpwdbcirk
clpwdbcirky -- clpwdbc, prirky	{#insert zzjlCodeOnPrekIRY}{#insert zzClpwdbPostPrek}	clpwdbcirky
clpwdbefk -- clpwdb, prefk	{#insert zzjlCodeOffPrekEF}{#insert zzClpwdbPostPrek}	clpwdbefk
clpwdbefky -- clpwdb, prefky	{#insert zzjlCodeOffPrekEFY}{#insert zzClpwdbPostPrek}	clpwdbefky
clpwdberk -- clpwdb, prerk	{#insert zzjlCodeOffPrekER}{#insert zzClpwdbPostPrek}	clpwdberk
clpwdberky -- clpwdb, prerky	{#insert zzjlCodeOffPrekERY}{#insert zzClpwdbPostPrek}	clpwdberky
clpwdbifk -- clpwdb, prifk	{#insert zzjlCodeOffPrekIF}{#insert zzClpwdbPostPrek}	clpwdbifk
clpwdbifky -- clpwdb, prifky	{#insert zzjlCodeOffPrekIFY}{#insert zzClpwdbPostPrek}	clpwdbifky
clpwdbirk -- clpwdb, prirk	{#insert zzjlCodeOffPrekIR}{#insert zzClpwdbPostPrek}	clpwdbirk
clpwdbirky -- clpwdb, prirky	{#insert zzjlCodeOffPrekIRY}{#insert zzClpwdbPostPrek}	clpwdbirky
clpwdcefk -- clpwdc, prefk	{#insert zzjlCodeOnPrekEF}{#insert zzClpwdPostPrek}	clpwdcefk
clpwdcefky -- clpwdc, prefky	{#insert zzjlCodeOnPrekEFY}{#insert zzClpwdPostPrek}	clpwdcefky
clpwdcerk -- clpwdc, prerk	{#insert zzjlCodeOnPrekER}{#insert zzClpwdPostPrek}	clpwdcerk
clpwdcerky -- clpwdc, prerky	{#insert zzjlCodeOnPrekERY}{#insert zzClpwdPostPrek}	clpwdcerky
clpwdcifk -- clpwdc, prifk	{#insert zzjlCodeOnPrekIF}{#insert zzClpwdPostPrek}	clpwdcifk
clpwdcifky -- clpwdc, prifky	{#insert zzjlCodeOnPrekIFY}{#insert zzClpwdPostPrek}	clpwdcifky
clpwdcirk -- clpwdc, prirk	{#insert zzjlCodeOnPrekIR}{#insert zzClpwdPostPrek}	clpwdcirk
clpwdcirky -- clpwdc, prirky	{#insert zzjlCodeOnPrekIRY}{#insert zzClpwdPostPrek}	clpwdcirky
clpwdefk -- clpwd, prefk	{#insert zzjlCodeOffPrekEF}{#insert zzClpwdPostPrek}	clpwdefk
clpwdefky -- clpwd, prefky	{#insert zzjlCodeOffPrekEFY}{#insert zzClpwdPostPrek}	clpwdefky
clpwderk -- clpwd, prerk	{#insert zzjlCodeOffPrekER}{#insert zzClpwdPostPrek}	clpwderk
clpwderky -- clpwd, prerky	{#insert zzjlCodeOffPrekERY}{#insert zzClpwdPostPrek}	clpwderky
clpwdifk -- clpwd, prifk	{#insert zzjlCodeOffPrekIF}{#insert zzClpwdPostPrek}	clpwdifk
clpwdifky -- clpwd, prifky	{#insert zzjlCodeOffPrekIFY}{#insert zzClpwdPostPrek}	clpwdifky
clpwdirk -- clpwd, prirk	{#insert zzjlCodeOffPrekIR}{#insert zzClpwdPostPrek}	clpwdirk
clpwdirky -- clpwd, prirky	{#insert zzjlCodeOffPrekIRY}{#insert zzClpwdPostPrek}	clpwdirky
clpwefk -- clpw, prefk	{#insert zzjlCodeOffPrekEF}{#insert zzClpwPostPrek}	clpwefk
clpwefky -- clpw, prefky	{#insert zzjlCodeOffPrekEFY}{#insert zzClpwPostPrek}	clpwefky
clpwerk -- clpw, prerk	{#insert zzjlCodeOffPrekER}{#insert zzClpwPostPrek}	clpwerk
clpwerky -- clpw, prerky	{#insert zzjlCodeOffPrekERY}{#insert zzClpwPostPrek}	clpwerky
clpwifk -- clpw, prifk	{#insert zzjlCodeOffPrekIF}{#insert zzClpwPostPrek}	clpwifk
clpwifky -- clpw, prifky	{#insert zzjlCodeOffPrekIFY}{#insert zzClpwPostPrek}	clpwifky
clpwirk -- clpw, prirk	{#insert zzjlCodeOffPrekIR}{#insert zzClpwPostPrek}	clpwirk
clpwirky -- clpw, prirky	{#insert zzjlCodeOffPrekIRY}{#insert zzClpwPostPrek}	clpwirky
