__XBN-PhraseExpress is released under the LGPL 2.1	(*XBN-PhraseExpress is a large set of generically-useful Microsoft Windows scripting tools, written in PhraseExpress, using the plain-text editor TextPad as its foundation.  //  Copyright (C) 2013 Jeff Epstein  //  This library is free software; you can redistribute it and/or modify it under the terms of the GNU Lesser General Public License as published by the Free Software Foundation; either version 2.1 of the License, or (at your option) any later version.  //  This library is distributed in the hope that it will be useful, but WITHOUT ANY WARRANTY; without even the implied warranty of MERCHANTABILITY or FITNESS FOR A PARTICULAR PURPOSE. See the GNU Lesser General Public License for more details.  //  You should have received a copy of the GNU Lesser General Public License along with this library; if not, write to the Free Software Foundation, Inc., 51 Franklin Street, Fifth Floor, Boston, MA 02110-1301 USA*)		(*Two tabs plus this comment, to force this phrase to be (a) imported, and (b) with NO autotext*)
flcbfefk -- flcbf, prefk	{#insert zzjlCodeOffPrekEF}{#insert zzFlcbfPostPrek}	flcbfefk
flcbfefky -- flcbf, prefky	{#insert zzjlCodeOffPrekEFY}{#insert zzFlcbfPostPrek}	flcbfefky
flcbferk -- flcbf, prerk	{#insert zzjlCodeOffPrekER}{#insert zzFlcbfPostPrek}	flcbferk
flcbferky -- flcbf, prerky	{#insert zzjlCodeOffPrekERY}{#insert zzFlcbfPostPrek}	flcbferky
flcbfifk -- flcbf, prifk	{#insert zzjlCodeOffPrekIF}{#insert zzFlcbfPostPrek}	flcbfifk
flcbfifky -- flcbf, prifky	{#insert zzjlCodeOffPrekIFY}{#insert zzFlcbfPostPrek}	flcbfifky
flcbfirk -- flcbf, prirk	{#insert zzjlCodeOffPrekIR}{#insert zzFlcbfPostPrek}	flcbfirk
flcbfirky -- flcbf, prirky	{#insert zzjlCodeOffPrekIRY}{#insert zzFlcbfPostPrek}	flcbfirky
flcbfcefk -- flcbfc, prefk	{#insert zzjlCodeOnPrekEF}{#insert zzFlcbfPostPrek}	flcbfcefk
flcbfcefky -- flcbfc, prefky	{#insert zzjlCodeOnPrekEFY}{#insert zzFlcbfPostPrek}	flcbfcefky
flcbfcerk -- flcbfc, prerk	{#insert zzjlCodeOnPrekER}{#insert zzFlcbfPostPrek}	flcbfcerk
flcbfcerky -- flcbfc, prerky	{#insert zzjlCodeOnPrekERY}{#insert zzFlcbfPostPrek}	flcbfcerky
flcbfcifk -- flcbfc, prifk	{#insert zzjlCodeOnPrekIF}{#insert zzFlcbfPostPrek}	flcbfcifk
flcbfcifky -- flcbfc, prifky	{#insert zzjlCodeOnPrekIFY}{#insert zzFlcbfPostPrek}	flcbfcifky
flcbfcirk -- flcbfc, prirk	{#insert zzjlCodeOnPrekIR}{#insert zzFlcbfPostPrek}	flcbfcirk
flcbfcirky -- flcbfc, prirky	{#insert zzjlCodeOnPrekIRY}{#insert zzFlcbfPostPrek}	flcbfcirky
flcbrefk -- flcbr, prefk	{#insert zzjlCodeOffPrekEF}{#insert zzFlcbrPostPrek}	flcbrefk
flcbrefky -- flcbr, prefky	{#insert zzjlCodeOffPrekEFY}{#insert zzFlcbrPostPrek}	flcbrefky
flcbrerk -- flcbr, prerk	{#insert zzjlCodeOffPrekER}{#insert zzFlcbrPostPrek}	flcbrerk
flcbrerky -- flcbr, prerky	{#insert zzjlCodeOffPrekERY}{#insert zzFlcbrPostPrek}	flcbrerky
flcbrifk -- flcbr, prifk	{#insert zzjlCodeOffPrekIF}{#insert zzFlcbrPostPrek}	flcbrifk
flcbrifky -- flcbr, prifky	{#insert zzjlCodeOffPrekIFY}{#insert zzFlcbrPostPrek}	flcbrifky
flcbrirk -- flcbr, prirk	{#insert zzjlCodeOffPrekIR}{#insert zzFlcbrPostPrek}	flcbrirk
flcbrirky -- flcbr, prirky	{#insert zzjlCodeOffPrekIRY}{#insert zzFlcbrPostPrek}	flcbrirky
flcbrcefk -- flcbrc, prefk	{#insert zzjlCodeOnPrekEF}{#insert zzFlcbrPostPrek}	flcbrcefk
flcbrcefky -- flcbrc, prefky	{#insert zzjlCodeOnPrekEFY}{#insert zzFlcbrPostPrek}	flcbrcefky
flcbrcerk -- flcbrc, prerk	{#insert zzjlCodeOnPrekER}{#insert zzFlcbrPostPrek}	flcbrcerk
flcbrcerky -- flcbrc, prerky	{#insert zzjlCodeOnPrekERY}{#insert zzFlcbrPostPrek}	flcbrcerky
flcbrcifk -- flcbrc, prifk	{#insert zzjlCodeOnPrekIF}{#insert zzFlcbrPostPrek}	flcbrcifk
flcbrcifky -- flcbrc, prifky	{#insert zzjlCodeOnPrekIFY}{#insert zzFlcbrPostPrek}	flcbrcifky
flcbrcirk -- flcbrc, prirk	{#insert zzjlCodeOnPrekIR}{#insert zzFlcbrPostPrek}	flcbrcirk
flcbrcirky -- flcbrc, prirky	{#insert zzjlCodeOnPrekIRY}{#insert zzFlcbrPostPrek}	flcbrcirky
flpwdbcefk -- flpwdbc, prefk	{#insert zzjlCodeOnPrekEF}{#insert zzFlpwdbPostPrek}	flpwdbcefk
flpwdbcefky -- flpwdbc, prefky	{#insert zzjlCodeOnPrekEFY}{#insert zzFlpwdbPostPrek}	flpwdbcefky
flpwdbcifk -- flpwdbc, prifk	{#insert zzjlCodeOnPrekIF}{#insert zzFlpwdbPostPrek}	flpwdbcifk
flpwdbcifky -- flpwdbc, prifky	{#insert zzjlCodeOnPrekIFY}{#insert zzFlpwdbPostPrek}	flpwdbcifky
flpwdbefk -- flpwdb, prefk	{#insert zzjlCodeOffPrekEF}{#insert zzFlpwdbPostPrek}	flpwdbefk
flpwdbefky -- flpwdb, prefky	{#insert zzjlCodeOffPrekEFY}{#insert zzFlpwdbPostPrek}	flpwdbefky
flpwdbifk -- flpwdb, prifk	{#insert zzjlCodeOffPrekIF}{#insert zzFlpwdbPostPrek}	flpwdbifk
flpwdbifky -- flpwdb, prifky	{#insert zzjlCodeOffPrekIFY}{#insert zzFlpwdbPostPrek}	flpwdbifky
flpwfbefk -- flpwfb, prefk	{#insert zzjlCodeOffPrekEF}{#insert zzFlpwfbcPostPrek}	flpwfbefk
flpwfbefky -- flpwfb, prefky	{#insert zzjlCodeOffPrekEFY}{#insert zzFlpwfbcPostPrek}	flpwfbefky
flpwfbifk -- flpwfb, prifk	{#insert zzjlCodeOffPrekIF}{#insert zzFlpwfbcPostPrek}	flpwfbifk
flpwfbifky -- flpwfb, prifky	{#insert zzjlCodeOffPrekIFY}{#insert zzFlpwfbcPostPrek}	flpwfbifky
flpwfbcefk -- flpwfbc, prefk	{#insert zzjlCodeOnPrekEF}{#insert zzFlpwfbcPostPrek}	flpwfbcefk
flpwfbcefky -- flpwfbc, prefky	{#insert zzjlCodeOnPrekEFY}{#insert zzFlpwfbcPostPrek}	flpwfbcefky
flpwfbcifk -- flpwfbc, prifk	{#insert zzjlCodeOnPrekIF}{#insert zzFlpwfbcPostPrek}	flpwfbcifk
flpwfbcifky -- flpwfbc, prifky	{#insert zzjlCodeOnPrekIFY}{#insert zzFlpwfbcPostPrek}	flpwfbcifky
flpwrefk -- flpwr, prefk	{#insert zzjlCodeOffPrekEF}{#insert zzFlpwrPostPrek}	flpwrefk
flpwrefky -- flpwr, prefky	{#insert zzjlCodeOffPrekEFY}{#insert zzFlpwrPostPrek}	flpwrefky
flpwrerk -- flpwr, prerk	{#insert zzjlCodeOffPrekER}{#insert zzFlpwrPostPrek}	flpwrerk
flpwrerky -- flpwr, prerky	{#insert zzjlCodeOffPrekERY}{#insert zzFlpwrPostPrek}	flpwrerky
flpwrifk -- flpwr, prifk	{#insert zzjlCodeOffPrekIF}{#insert zzFlpwrPostPrek}	flpwrifk
flpwrifky -- flpwr, prifky	{#insert zzjlCodeOffPrekIFY}{#insert zzFlpwrPostPrek}	flpwrifky
flpwrirk -- flpwr, prirk	{#insert zzjlCodeOffPrekIR}{#insert zzFlpwrPostPrek}	flpwrirk
flpwrirky -- flpwr, prirky	{#insert zzjlCodeOffPrekIRY}{#insert zzFlpwrPostPrek}	flpwrirky
flpwrcefk -- flpwrc, prefk	{#insert zzjlCodeOnPrekEF}{#insert zzFlpwrPostPrek}	flpwrcefk
flpwrcefky -- flpwrc, prefky	{#insert zzjlCodeOnPrekEFY}{#insert zzFlpwrPostPrek}	flpwrcefky
flpwrcerk -- flpwrc, prerk	{#insert zzjlCodeOnPrekER}{#insert zzFlpwrPostPrek}	flpwrcerk
flpwrcerky -- flpwrc, prerky	{#insert zzjlCodeOnPrekERY}{#insert zzFlpwrPostPrek}	flpwrcerky
flpwrcifk -- flpwrc, prifk	{#insert zzjlCodeOnPrekIF}{#insert zzFlpwrPostPrek}	flpwrcifk
flpwrcifky -- flpwrc, prifky	{#insert zzjlCodeOnPrekIFY}{#insert zzFlpwrPostPrek}	flpwrcifky
flpwrcirk -- flpwrc, prirk	{#insert zzjlCodeOnPrekIR}{#insert zzFlpwrPostPrek}	flpwrcirk
flpwrcirky -- flpwrc, prirky	{#insert zzjlCodeOnPrekIRY}{#insert zzFlpwrPostPrek}	flpwrcirky
