olcbcefk -- olcbc, prefk	{#insert zzjlCodeOnPrekEF}{#insert zzOlcbPostPrek}	olcbcefk
olcbcefky -- olcbc, prefky	{#insert zzjlCodeOnPrekEFY}{#insert zzOlcbPostPrek}	olcbcefky
olcbcerk -- olcbc, prerk	{#insert zzjlCodeOnPrekER}{#insert zzOlcbPostPrek}	olcbcerk
olcbcerky -- olcbc, prerky	{#insert zzjlCodeOnPrekERY}{#insert zzOlcbPostPrek}	olcbcerky
olcbcifk -- olcbc, prifk	{#insert zzjlCodeOnPrekIF}{#insert zzOlcbPostPrek}	olcbcifk
olcbcifky -- olcbc, prifky	{#insert zzjlCodeOnPrekIFY}{#insert zzOlcbPostPrek}	olcbcifky
olcbcirk -- olcbc, prirk	{#insert zzjlCodeOnPrekIR}{#insert zzOlcbPostPrek}	olcbcirk
olcbcirky -- olcbc, prirky	{#insert zzjlCodeOnPrekIRY}{#insert zzOlcbPostPrek}	olcbcirky
olcbefk -- olcb, prefk	{#insert zzjlCodeOffPrekEF}{#insert zzOlcbPostPrek}	olcbefk
olcbefky -- olcb, prefky	{#insert zzjlCodeOffPrekEFY}{#insert zzOlcbPostPrek}	olcbefky
olcberk -- olcb, prerk	{#insert zzjlCodeOffPrekER}{#insert zzOlcbPostPrek}	olcberk
olcberky -- olcb, prerky	{#insert zzjlCodeOffPrekERY}{#insert zzOlcbPostPrek}	olcberky
olcbifk -- olcb, prifk	{#insert zzjlCodeOffPrekIF}{#insert zzOlcbPostPrek}	olcbifk
olcbifky -- olcb, prifky	{#insert zzjlCodeOffPrekIFY}{#insert zzOlcbPostPrek}	olcbifky
olcbirk -- olcb, prirk	{#insert zzjlCodeOffPrekIR}{#insert zzOlcbPostPrek}	olcbirk
olcbirky -- olcb, prirky	{#insert zzjlCodeOffPrekIRY}{#insert zzOlcbPostPrek}	olcbirky
olcbrcefk -- olcbrc, prefk	{#insert zzjlCodeOnPrekEF}{#insert zzOlcbrPostPrek}	olcbrcefk
olcbrcefky -- olcbrc, prefky	{#insert zzjlCodeOnPrekEFY}{#insert zzOlcbrPostPrek}	olcbrcefky
olcbrcerk -- olcbrc, prerk	{#insert zzjlCodeOnPrekER}{#insert zzOlcbrPostPrek}	olcbrcerk
olcbrcerky -- olcbrc, prerky	{#insert zzjlCodeOnPrekERY}{#insert zzOlcbrPostPrek}	olcbrcerky
olcbrcifk -- olcbrc, prifk	{#insert zzjlCodeOnPrekIF}{#insert zzOlcbrPostPrek}	olcbrcifk
olcbrcifky -- olcbrc, prifky	{#insert zzjlCodeOnPrekIFY}{#insert zzOlcbrPostPrek}	olcbrcifky
olcbrcirk -- olcbrc, prirk	{#insert zzjlCodeOnPrekIR}{#insert zzOlcbrPostPrek}	olcbrcirk
olcbrcirky -- olcbrc, prirky	{#insert zzjlCodeOnPrekIRY}{#insert zzOlcbrPostPrek}	olcbrcirky
olcbrefk -- olcbr, prefk	{#insert zzjlCodeOffPrekEF}{#insert zzOlcbrPostPrek}	olcbrefk
olcbrefky -- olcbr, prefky	{#insert zzjlCodeOffPrekEFY}{#insert zzOlcbrPostPrek}	olcbrefky
olcbrerk -- olcbr, prerk	{#insert zzjlCodeOffPrekER}{#insert zzOlcbrPostPrek}	olcbrerk
olcbrerky -- olcbr, prerky	{#insert zzjlCodeOffPrekERY}{#insert zzOlcbrPostPrek}	olcbrerky
olcbrifk -- olcbr, prifk	{#insert zzjlCodeOffPrekIF}{#insert zzOlcbrPostPrek}	olcbrifk
olcbrifky -- olcbr, prifky	{#insert zzjlCodeOffPrekIFY}{#insert zzOlcbrPostPrek}	olcbrifky
olcbrirk -- olcbr, prirk	{#insert zzjlCodeOffPrekIR}{#insert zzOlcbrPostPrek}	olcbrirk
olcbrirky -- olcbr, prirky	{#insert zzjlCodeOffPrekIRY}{#insert zzOlcbrPostPrek}	olcbrirky
olpwcefk -- olpwc, prefk	{#insert zzjlCodeOnPrekEF}{#insert zzOlpwPostPrek}	olpwcefk
olpwcefky -- olpwc, prefky	{#insert zzjlCodeOnPrekEFY}{#insert zzOlpwPostPrek}	olpwcefky
olpwcerk -- olpwc, prerk	{#insert zzjlCodeOnPrekER}{#insert zzOlpwPostPrek}	olpwcerk
olpwcerky -- olpwc, prerky	{#insert zzjlCodeOnPrekERY}{#insert zzOlpwPostPrek}	olpwcerky
olpwcifk -- olpwc, prifk	{#insert zzjlCodeOnPrekIF}{#insert zzOlpwPostPrek}	olpwcifk
olpwcifky -- olpwc, prifky	{#insert zzjlCodeOnPrekIFY}{#insert zzOlpwPostPrek}	olpwcifky
olpwcirk -- olpwc, prirk	{#insert zzjlCodeOnPrekIR}{#insert zzOlpwPostPrek}	olpwcirk
olpwcirky -- olpwc, prirky	{#insert zzjlCodeOnPrekIRY}{#insert zzOlpwPostPrek}	olpwcirky
olpwefk -- olpw, prefk	{#insert zzjlCodeOffPrekEF}{#insert zzOlpwPostPrek}	olpwefk
olpwefky -- olpw, prefky	{#insert zzjlCodeOffPrekEFY}{#insert zzOlpwPostPrek}	olpwefky
olpwerk -- olpw, prerk	{#insert zzjlCodeOffPrekER}{#insert zzOlpwPostPrek}	olpwerk
olpwerky -- olpw, prerky	{#insert zzjlCodeOffPrekERY}{#insert zzOlpwPostPrek}	olpwerky
olpwfbcefk -- olpwfbc, prefk	{#insert zzjlCodeOnPrekEF}{#insert zzOlpwfbPostPrek}	olpwfbcefk
olpwfbcefky -- olpwfbc, prefky	{#insert zzjlCodeOnPrekEFY}{#insert zzOlpwfbPostPrek}	olpwfbcefky
olpwfbcerk -- olpwfbc, prerk	{#insert zzjlCodeOnPrekER}{#insert zzOlpwfbPostPrek}	olpwfbcerk
olpwfbcerky -- olpwfbc, prerky	{#insert zzjlCodeOnPrekERY}{#insert zzOlpwfbPostPrek}	olpwfbcerky
olpwfbcifk -- olpwfbc, prifk	{#insert zzjlCodeOnPrekIF}{#insert zzOlpwfbPostPrek}	olpwfbcifk
olpwfbcifky -- olpwfbc, prifky	{#insert zzjlCodeOnPrekIFY}{#insert zzOlpwfbPostPrek}	olpwfbcifky
olpwfbcirk -- olpwfbc, prirk	{#insert zzjlCodeOnPrekIR}{#insert zzOlpwfbPostPrek}	olpwfbcirk
olpwfbcirky -- olpwfbc, prirky	{#insert zzjlCodeOnPrekIRY}{#insert zzOlpwfbPostPrek}	olpwfbcirky
olpwfbefk -- olpwfb, prefk	{#insert zzjlCodeOffPrekEF}{#insert zzOlpwfbPostPrek}	olpwfbk
olpwfbefky -- olpwfb, prfky	{#insert zzjlCodeOffPrekEFY}{#insert zzOlpwfbPostPrek}	olpwfbk
olpwfberk -- olpwfb, prerk	{#insert zzjlCodeOffPrekER}{#insert zzOlpwfbPostPrek}	olpwfbk
olpwfberky -- olpwfb, prrky	{#insert zzjlCodeOffPrekERY}{#insert zzOlpwfbPostPrek}	olpwfbk
olpwfbifk -- olpwfb, prifk	{#insert zzjlCodeOffPrekIF}{#insert zzOlpwfbPostPrek}	olpwfbk
olpwfbifky -- olpwfb, prfky	{#insert zzjlCodeOffPrekIFY}{#insert zzOlpwfbPostPrek}	olpwfbk
olpwfbirk -- olpwfb, prirk	{#insert zzjlCodeOffPrekER}{#insert zzOlpwfbPostPrek}	olpwfbk
olpwfbirky -- olpwfb, prrky	{#insert zzjlCodeOffPrekIRY}{#insert zzOlpwfbPostPrek}	olpwfbk
olpwfcefk -- olpwfc, prefk	{#insert zzjlCodeOnPrekEF}{#insert zzOlpwfPostPrek}	olpwfcefk
olpwfcefky -- olpwfc, prefky	{#insert zzjlCodeOnPrekEFY}{#insert zzOlpwfPostPrek}	olpwfcefky
olpwfcerk -- olpwfc, prerk	{#insert zzjlCodeOnPrekER}{#insert zzOlpwfPostPrek}	olpwfcerk
olpwfcerky -- olpwfc, prerky	{#insert zzjlCodeOnPrekERY}{#insert zzOlpwfPostPrek}	olpwfcerky
olpwfcifk -- olpwfc, prifk	{#insert zzjlCodeOnPrekIF}{#insert zzOlpwfPostPrek}	olpwfcifk
olpwfcifky -- olpwfc, prifky	{#insert zzjlCodeOnPrekIFY}{#insert zzOlpwfPostPrek}	olpwfcifky
olpwfcirk -- olpwfc, prirk	{#insert zzjlCodeOnPrekIR}{#insert zzOlpwfPostPrek}	olpwfcirk
olpwfcirky -- olpwfc, prirky	{#insert zzjlCodeOnPrekIRY}{#insert zzOlpwfPostPrek}	olpwfcirky
olpwfefk -- olpwf, prefk	{#insert zzjlCodeOffPrekEF}{#insert zzOlpwfPostPrek}	olpwfefk
olpwfefky -- olpwf, prefky	{#insert zzjlCodeOffPrekEFY}{#insert zzOlpwfPostPrek}	olpwfefky
olpwferk -- olpwf, prerk	{#insert zzjlCodeOffPrekER}{#insert zzOlpwfPostPrek}	olpwferk
olpwferky -- olpwf, prerky	{#insert zzjlCodeOffPrekERY}{#insert zzOlpwfPostPrek}	olpwferky
olpwfifk -- olpwf, prifk	{#insert zzjlCodeOffPrekIF}{#insert zzOlpwfPostPrek}	olpwfifk
olpwfifky -- olpwf, prifky	{#insert zzjlCodeOffPrekIFY}{#insert zzOlpwfPostPrek}	olpwfifky
olpwfirk -- olpwf, prirk	{#insert zzjlCodeOffPrekIR}{#insert zzOlpwfPostPrek}	olpwfirk
olpwfirky -- olpwf, prirky	{#insert zzjlCodeOffPrekIRY}{#insert zzOlpwfPostPrek}	olpwfirky
olpwifk -- olpw, prifk	{#insert zzjlCodeOffPrekIF}{#insert zzOlpwPostPrek}	olpwifk
olpwifky -- olpw, prifky	{#insert zzjlCodeOffPrekIFY}{#insert zzOlpwPostPrek}	olpwifky
olpwirk -- olpw, prirk	{#insert zzjlCodeOffPrekIR}{#insert zzOlpwPostPrek}	olpwirk
olpwirky -- olpw, prirky	{#insert zzjlCodeOffPrekIRY}{#insert zzOlpwPostPrek}	olpwirky
olpwrcefk -- olpwrc, prefk	{#insert zzjlCodeOnPrekEF}{#insert zzOlpwrPostPrek}	olpwrcefk
olpwrcefky -- olpwrc, prefky	{#insert zzjlCodeOnPrekEFY}{#insert zzOlpwrPostPrek}	olpwrcefky
olpwrcerk -- olpwrc, prerk	{#insert zzjlCodeOnPrekER}{#insert zzOlpwrPostPrek}	olpwrcerk
olpwrcerky -- olpwrc, prerky	{#insert zzjlCodeOnPrekERY}{#insert zzOlpwrPostPrek}	olpwrcerky
olpwrcifk -- olpwrc, prifk	{#insert zzjlCodeOnPrekIF}{#insert zzOlpwrPostPrek}	olpwrcifk
olpwrcifky -- olpwrc, prifky	{#insert zzjlCodeOnPrekIFY}{#insert zzOlpwrPostPrek}	olpwrcifky
olpwrcirk -- olpwrc, prirk	{#insert zzjlCodeOnPrekIR}{#insert zzOlpwrPostPrek}	olpwrcirk
olpwrcirky -- olpwrc, prirky	{#insert zzjlCodeOnPrekIRY}{#insert zzOlpwrPostPrek}	olpwrcirky
olpwrefk -- olpwr, prefk	{#insert zzjlCodeOffPrekEF}{#insert zzOlpwrPostPrek}	olpwrefk
olpwrefky -- olpwr, prefky	{#insert zzjlCodeOffPrekEFY}{#insert zzOlpwrPostPrek}	olpwrefky
olpwrerk -- olpwr, prerk	{#insert zzjlCodeOffPrekER}{#insert zzOlpwrPostPrek}	olpwrerk
olpwrerky -- olpwr, prerky	{#insert zzjlCodeOffPrekERY}{#insert zzOlpwrPostPrek}	olpwrerky
olpwrifk -- olpwr, prifk	{#insert zzjlCodeOffPrekIF}{#insert zzOlpwrPostPrek}	olpwrifk
olpwrifky -- olpwr, prifky	{#insert zzjlCodeOffPrekIFY}{#insert zzOlpwrPostPrek}	olpwrifky
olpwrirk -- olpwr, prirk	{#insert zzjlCodeOffPrekIR}{#insert zzOlpwrPostPrek}	olpwrirk
olpwrirky -- olpwr, prirky	{#insert zzjlCodeOffPrekIRY}{#insert zzOlpwrPostPrek}	olpwrirky
