__XBN-PhraseExpress is released under the LGPL 2.1	(*XBN-PhraseExpress: Large set of generically useful scripting tools for MS Windows, written in PhraseExpress and TextPad.  //  Copyright (C) 2013 Jeff Epstein  //  This library is free software; you can redistribute it and/or modify it under the terms of the GNU Lesser General Public License as published by the Free Software Foundation; either version 2.1 of the License, or (at your option) any later version.  //  This library is distributed in the hope that it will be useful, but WITHOUT ANY WARRANTY; without even the implied warranty of MERCHANTABILITY or FITNESS FOR A PARTICULAR PURPOSE. See the GNU Lesser General Public License for more details.  //  You should have received a copy of the GNU Lesser General Public License along with this library; if not, write to the Free Software Foundation, Inc., 51 Franklin Street, Fifth Floor, Boston, MA 02110-1301 USA*)		(*Two tabs plus this comment, to force this phrase to be (a) imported, and (b) with NO autotext*)
zzREonRplcNewLinesToNothing	{#insert zFcsTPRplcDlgOpen}{#insert zzMidRplcRENewlnToNothing}{#insert zRplcBtnAllSelHnr}{#insert zRplcDlgClose}	zzREonRplcNewLinesToNothing
zzREoffRplcNewLinesToNothing	(*RE=off*){#insert zRplcDlgOpenRE}(*RE=on*){#insert zzMidRplcRENewlnToNothing}{#insert zRplcBtnAllSelHnr}{#insert zRplcDlgClose}{#insert zTPFindFlagREon}(*RE=off*)	zzREoffRplcNewLinesToNothing

delmtlines -- zDelAllEmptyLinesButLastInDoc ALT KC	{#insert zDelAllEmptyLinesButLastInDoc}	delmtlines
markmtlines -- zMarkAllEmptyLinesButLastInDocZduDel ALT KC	{#insert zMarkAllEmptyLinesButLastInDocZduDel}	markmtlines
zMarkAllEmptyLinesButLastInDocZduDel	{#insert zMarkAllEmptyLinesButLastInDoc}{#insert zZDownUpDelete}	zMarkAllEmptyLinesButLastInDocZduDel
markmtlineswp -- zMarkAllEmptyLinesButLastInDocWCountPromptUnmark ALT KC	{#insert zMarkAllEmptyLinesButLastInDocWCountPromptUnmark}	markmtlineswp
zCutEntireLineNoNLDel	{#insert zCutEntireLineNoNL}{#insert zDEL}	zCutEntireLineNoNLDel
zDelAllEmptyLinesButLastInDoc -(*!!*)- Does not delete potential final empty-line	(*Warning: Eliminates any current selection!*){#insert zMarkAllEmptyLinesButLastInDoc}{#insert zTPBookmarkDeleteAll}{#insert zZDownUpDelete}	zDelAllEmptyLinesButLastInDoc
zDelToLineEnd -- zTPDelToEndOfLine X2	{#insert zTPDelToEndOfLine}{#insert zTPDelToEndOfLine}	zDelToLineEnd
zDeleteLine -- zTPDeleteLine ALT KC	{#insert zTPDeleteLine}	zDeleteLine
zDownHome	{#insert zDOWN}{#insert zHOME}	zDownHome
zDupLine -- zTPDupLine ALT KC	{#insert zTPDupLine}	zDupLine
zGTFirstNonWS -- Places cursor before the first non-whitespace char in line	{#insert zHOME}{#insert zMoveR1L1w}	zGTFirstNonWS
zHomeSpEND	{#insert zHOME}{#insert zSpEND}	zHomeSpEND
zMarkAllEmptyLinesButLastInDoc -(*!!*)- Does not mark potential final empty-line	(*Warning: Eliminates any current selection!*){#insert zzZFillLastLine}{#insert zFindOpenRE}^${#insert zFindMarkAllREClose}{#insert zzElimLastLineFill}	zMarkAllEmptyLinesButLastInDoc
zMarkAllEmptyLinesButLastInDocWCountPrompt -(*!!*)- Does not mark potential final empty-line	(*Warning: Eliminates any current selection!*){#insert zzZFillLastLine}{#insert zFindOpenRE}^${#insert zFindMarkAllRE}{#MSGBOX -head Empty lines marked -text All empty lines are marked. The number of marks is in the status bar.}{#insert zFindDlgClose}{#insert zzElimLastLineFill}{#insert zZDownUpDelete}	zMarkAllEmptyLinesButLastInDocWCountPrompt
zMarkAllEmptyLinesButLastInDocWCountPromptUnmark	{#insert zMarkAllEmptyLinesButLastInDocWCountPrompt}{#insert zTPBookmarkClearAll}	zMarkAllEmptyLinesButLastInDocWCountPromptUnmark
zWWGTFirstNonWS -- zTPToggleWW, zGTFirstNonWS	{#insert zTPToggleWW}{#insert zGTFirstNonWS}	zWWGTFirstNonWS
zvLINE_DOWN_COUNT_stPrompt	{#SETPHRASE -description zvLINE_UP_COUNT -content {#input -head Set zvLINE_DOWN_COUNT to? -single} -autotext zvLINE_DOWN_COUNT -folder ctvv_folder}	zvLINE_DOWN_COUNT_stPrompt
zvLINE_UP_COUNT_stPrompt	{#SETPHRASE -description zvLINE_UP_COUNT -content {#input -head Set zvLINE_UP_COUNT to? -single} -autotext zvLINE_UP_COUNT -folder ctvv_folder}	zvLINE_UP_COUNT_stPrompt
zzZFillLastLine	{#insert zZmark}{#insert zGTDocBottom}x	zzZFillLastLine
zzElimLastLineFill	{#insert zGTDocBottom}{#insert zBKSP}	zzElimLastLineFill