__XBN-PhraseExpress is released under the LGPL 2.1	(*XBN-PhraseExpress: Large set of generically useful scripting tools for MS Windows, written in PhraseExpress and TextPad.  //  Copyright (C) 2013 Jeff Epstein  //  This library is free software; you can redistribute it and/or modify it under the terms of the GNU Lesser General Public License as published by the Free Software Foundation; either version 2.1 of the License, or (at your option) any later version.  //  This library is distributed in the hope that it will be useful, but WITHOUT ANY WARRANTY; without even the implied warranty of MERCHANTABILITY or FITNESS FOR A PARTICULAR PURPOSE. See the GNU Lesser General Public License for more details.  //  You should have received a copy of the GNU Lesser General Public License along with this library; if not, write to the Free Software Foundation, Inc., 51 Franklin Street, Fifth Floor, Boston, MA 02110-1301 USA*)		(*Two tabs plus this comment, to force this phrase to be (a) imported, and (b) with NO autotext*)
(*
   Required by phrase-creator-ddmenu-utils...START
      PM_DDMENU_DIRID_FILENMPHRSNM_HDRAUTOTXT=tpkc/zzPmdmFNmPreTpkcPex/xhpc
   Required by phrase-creator-ddmenu-utils...END
*)
_The phrase in this document are intended...	...for use both in and out of TextPad		(*Two tabs plus this comment, to force this phrase to be (a) imported, and (b) with NO autotext*)
cpcb -- Call Phrase-name in ClipBoard (also works for other Pex code)	{#insert zCallPhraseNameInCB}{#insert cpcbsyn}	cpcb
cpcbx -- cpcb, w/o syntax balloon	{#insert zCallPhraseNameInCB}	cpcbx
cpwl -- sel-copy word-left, cpcb	{#insert zzCpwlRAW}{#insert cpcbsyn}	cpwl
cplq -- copy word-left, '=', cpcb	{#insert zzCplqRAW}{#insert cpcbsyn}	cplq
cplqx -- cplq, no syntax balloon	{#insert zzCplqRAW}	cplqx
cpln -- copy word-left, enter, cpcb	{#insert zzCplnRAW}{#insert cpcbsyn}	cpln
cplnn -- cplnnx, print syntax	{#insert cplnnx}{#insert cpcbsyn}	cplnn
cplnnx -- cpln, for a list-list of phrase-names	{#LOOP {#insert zEND}{#insert zzCplnRAW}{#insert zDOWN} -count {#INPUT -head How many phrase-name-lines? -single}}	cplnnx
cplnx -- cpln, no syntax balloon	{#insert zzCplnRAW}	cplnx
cpwlx -- cpwl, no syntax balloon	{#insert zzCpwlRAW}	cpwlx
cpwr -- sel-copy word-right, cpcb	{#insert zzCpwrRAW}{#insert cpcbsyn}	cpwr
cpwrx -- cpwr, no syntax baloon	{#insert zzCpwrRAW}	cpwrx
zCallPhraseNameInCB	{#insert {#INSERTCLIPBOARD}}	zCallPhraseNameInCB
cpcbsyn	{#BALLOON -title Syntax: cpcb -text   // cpcb[x] ~~ (in ClipBoard) // cpw[l,r][x] ~~ (word~left/right) // cpl[q,n[n]][x] ~~ (cpwl, '='/e'N'ter before execute, [nn]=phrs~nm line~list) // [x]=no syntax balloon}	cpcbsyn
zzCpwlRAW	{#insert zzzSelL1wCopyRight}{#insert zCallPhraseNameInCB}	zzCpwlRAW
zzCplqRAW	{#insert zzzSelL1wCopyRight}={#insert zCallPhraseNameInCB}	zzCplqRAW
zzCplnRAW	{#insert zzzSelL1wCopyRight}{#ENTER}{#insert zCallPhraseNameInCB}	zzCplnRAW
zzCpwrRAW	{#insert zTPSelectR1w}{#insert zTPCopy}{#LEFT}{#insert zCallPhraseNameInCB}	zzCpwrRAW
zzzSelL1wCopyRight	{#insert zTPSelectL1w}{#insert zTPCopy}{#RIGHT}	zzzSelL1wCopyRight
